,userId,itemId,Xmin,Ymin,Xmax,Ymax,L,H,P,S,L/H,D
0,1581,34804,86,640,242,743,156,103,518,16068,1.5145631067961165,186.93581786270923
1,1351,34804,85,655,273,766,188,111,598,20868,1.6936936936936935,218.3231549790356
2,161,34804,85,648,268,748,183,100,566,18300,1.83,208.54016399725018
3,313,5704,32,618,647,1268,615,650,2530,399750,0.946153846153846,894.8323865395128
4,1097,5704,25,620,602,1242,577,622,2398,358894,0.927652733118971,848.4179394614425
5,1525,5704,118,690,583,1191,465,501,1932,232965,0.9281437125748504,683.5393185472216
6,957,32082,50,437,259,575,209,138,694,28842,1.5144927536231885,250.44959572736389
7,947,32082,42,414,252,583,210,169,758,35490,1.242603550295858,269.5570440556136
8,237,32082,63,424,250,569,187,145,664,27115,1.289655172413793,236.63051367057463
9,191,32082,59,483,262,584,203,101,608,20503,2.00990099009901,226.73773395709856
10,465,32082,41,426,256,588,215,162,754,34830,1.3271604938271604,269.20066864701505
11,128,32082,40,433,259,577,219,144,726,31536,1.5208333333333333,262.1011255221923
12,307,25757,287,286,993,781,706,495,2402,349470,1.4262626262626263,862.2418454238926
13,1508,25757,389,389,803,715,414,326,1480,134964,1.2699386503067485,526.9459175285449
14,1454,25757,382,322,916,789,534,467,2002,249378,1.1434689507494646,709.3976317975695
15,161,18505,33,582,92,640,59,58,234,3422,1.0172413793103448,82.73451516749222
16,374,18505,35,584,93,639,58,55,226,3190,1.0545454545454545,79.93122043357026
17,1304,18505,37,599,67,627,30,28,116,840,1.0714285714285714,41.036569057366385
18,1033,18505,33,583,91,639,58,56,228,3248,1.0357142857142858,80.62257748298549
19,312,18505,34,583,91,639,57,56,226,3192,1.0178571428571428,79.90619500389191
20,1397,18505,36,587,89,635,53,48,202,2544,1.1041666666666667,71.50524456289902
21,195,7318,80,705,314,973,234,268,1004,62712,0.8731343283582089,355.7808314116993
22,1389,7318,70,685,356,975,286,290,1152,82940,0.986206896551724,407.3033267725664
23,1562,7318,109,714,323,961,214,247,922,52858,0.8663967611336032,326.8103425535979
24,873,4673,81,305,84,308,3,3,12,9,1.0,4.242640687119285
25,1396,4673,133,298,535,698,402,400,1604,160800,1.005,567.1014018674261
26,100,4673,29,281,690,712,661,431,2184,284891,1.5336426914153132,789.1020212874886
27,1404,4673,92,275,519,725,427,450,1754,192150,0.9488888888888888,620.3458712686013
28,545,4673,110,306,485,687,375,381,1512,142875,0.9842519685039369,534.5895621876656
29,1408,21769,308,633,616,1143,308,510,1636,157080,0.6039215686274509,595.788553095811
30,1222,21769,302,600,625,1117,323,517,1680,166991,0.6247582205029013,609.6047900074277
31,110,21769,325,609,631,1167,306,558,1728,170748,0.5483870967741935,636.3961030678928
32,1371,21769,257,556,634,1185,377,629,2012,237133,0.5993640699523053,733.328030283856
33,678,21769,293,514,637,1158,344,644,1976,221536,0.5341614906832298,730.1177987147006
34,1409,21769,198,532,533,1173,335,641,1952,214735,0.5226209048361935,723.260672233739
35,119,21769,272,541,604,1098,332,557,1778,184924,0.5960502692998204,648.4388945768136
36,384,9489,73,677,439,1202,366,525,1782,192150,0.6971428571428572,639.9851560778578
37,1038,9489,42,685,438,1281,396,596,1984,236016,0.6644295302013423,715.564113130333
38,886,9489,77,706,438,1179,361,473,1668,170753,0.7632135306553911,595.0210080324896
39,349,24538,57,1536,113,1571,56,35,182,1960,1.6,66.03786792439622
40,1228,24538,55,1525,89,1553,34,28,124,952,1.2142857142857142,44.04543109109048
41,242,24538,56,1522,112,1574,56,52,216,2912,1.0769230769230769,76.4198926981712
42,803,24538,54,1536,109,1572,55,36,182,1980,1.5277777777777777,65.73431371817918
43,687,24538,54,1536,110,1571,56,35,182,1960,1.6,66.03786792439622
44,952,24538,55,1538,67,1552,12,14,52,168,0.8571428571428571,18.439088914585774
45,339,24538,56,1516,110,1573,54,57,222,3078,0.9473684210526316,78.5175139698144
46,957,24538,57,1537,64,1557,7,20,54,140,0.35,21.18962010041709
47,486,7384,97,943,380,1128,283,185,936,52355,1.5297297297297296,338.10353443878694
48,492,7384,114,940,320,1108,206,168,748,34608,1.2261904761904765,265.81948762270986
49,1620,7384,125,946,381,1074,256,128,768,32768,2.0,286.2167011199731
50,1391,7384,129,949,389,1123,260,174,868,45240,1.4942528735632183,312.85140242613585
51,760,7384,114,935,115,936,1,1,4,1,1.0,1.4142135623730951
52,1389,7384,128,932,387,1127,259,195,908,50505,1.328205128205128,324.20055521235616
53,1617,7384,82,916,381,1117,299,201,1000,60099,1.4875621890547264,360.2804463192528
54,1508,7384,106,925,177,1088,71,163,468,11573,0.4355828220858896,177.79201331893398
55,1340,7384,166,996,192,1025,26,29,110,754,0.8965517241379308,38.948684188300895
56,654,24633,194,935,717,1439,523,504,2054,263592,1.0376984126984128,726.3229309336172
57,657,24633,151,949,892,1441,741,492,2466,364572,1.5060975609756098,889.4633213348372
58,1030,24633,173,918,787,1400,614,482,2192,295948,1.2738589211618256,780.5895208110342
59,1162,24633,229,941,717,1338,488,397,1770,193736,1.2292191435768265,629.0890239067918
60,1090,24633,210,1018,792,1360,582,342,1848,199044,1.7017543859649122,675.0466650536094
61,1123,25034,327,566,727,886,400,320,1440,128000,1.25,512.2499389946279
62,957,25034,336,632,793,1021,457,389,1692,177773,1.174807197943445,600.1416499460773
63,1053,25034,299,600,711,951,412,351,1526,144612,1.1737891737891737,541.2439376103903
64,687,25034,389,578,678,901,289,323,1224,93347,0.8947368421052632,433.4166586553867
65,674,17723,19,502,40,519,21,17,76,357,1.2352941176470589,27.018512172212592
66,560,17723,20,506,30,513,10,7,34,70,1.4285714285714286,12.206555615733702
67,389,17723,20,504,30,513,10,9,38,90,1.1111111111111112,13.45362404707371
68,457,17723,19,502,38,519,19,17,72,323,1.1176470588235294,25.495097567963924
69,170,17723,19,503,37,517,18,14,64,252,1.2857142857142858,22.80350850198276
70,321,17723,19,504,34,516,15,12,54,180,1.25,19.209372712298546
71,451,17723,19,502,30,514,11,12,46,132,0.9166666666666666,16.278820596099706
72,1701,17723,18,503,30,515,12,12,48,144,1.0,16.97056274847714
73,161,13593,174,367,522,668,348,301,1298,104748,1.1561461794019934,460.11411627986377
74,1355,13593,163,360,524,758,361,398,1518,143678,0.907035175879397,537.3313688963264
75,917,13593,162,376,530,632,368,256,1248,94208,1.4375,448.2856232359008
76,497,13593,184,358,520,708,336,350,1372,117600,0.96,485.1762566325768
77,1631,13593,176,335,624,693,448,358,1612,160384,1.2513966480446927,573.470138716917
78,1402,13593,176,360,538,689,362,329,1382,119098,1.1003039513677813,489.16766041920636
79,1212,13593,169,376,353,670,184,294,956,54096,0.6258503401360545,346.8313711301214
80,1091,13593,200,396,493,628,293,232,1050,67976,1.262931034482759,373.72851108792867
81,820,13593,211,392,365,563,154,171,650,26334,0.9005847953216374,230.1238796822268
82,379,1565,87,747,225,786,138,39,354,5382,3.5384615384615383,143.40502083260543
83,1400,1565,135,733,218,804,83,71,308,5893,1.1690140845070425,109.22453936730518
84,1749,1565,77,739,227,795,150,56,412,8400,2.6785714285714284,160.11246047700348
85,1098,1565,72,735,225,799,153,64,434,9792,2.390625,165.8463143998081
86,1742,1565,86,730,228,813,142,83,450,11786,1.710843373493976,164.47796204963143
87,382,1565,73,737,218,823,145,86,462,12470,1.6860465116279069,168.5852899869974
88,496,1565,100,743,222,792,122,49,342,5978,2.489795918367347,131.47243057006287
89,1360,1565,61,725,223,824,162,99,522,16038,1.6363636363636365,189.85520798756087
90,831,1565,69,737,222,823,153,86,478,13158,1.7790697674418603,175.5135322418189
91,1356,1565,83,736,223,803,140,67,414,9380,2.08955223880597,155.2063143045411
92,865,20434,56,917,230,1076,174,159,666,27666,1.0943396226415094,235.7053245049844
93,592,20434,52,910,238,1073,186,163,698,30318,1.1411042944785277,247.315587862957
94,426,20434,50,929,217,1071,167,142,618,23714,1.176056338028169,219.20994502987313
95,67,16335,107,117,877,680,770,563,2666,433510,1.3676731793960923,953.8705362888613
96,1606,16335,119,105,887,717,768,612,2760,470016,1.2549019607843137,982.0224030031087
97,1267,16335,56,160,791,693,735,533,2536,391755,1.3789868667917449,907.9173971237692
98,552,15874,119,571,291,849,172,278,900,47816,0.6187050359712231,326.90671452266014
99,1684,15874,81,558,309,887,228,329,1114,75012,0.6930091185410334,400.2811511925087
100,447,15874,105,576,296,780,191,204,790,38964,0.9362745098039216,279.45840477609545
101,1385,723,84,180,778,718,694,538,2464,373372,1.2899628252788105,878.1116102182
102,1023,723,163,199,889,719,726,520,2492,377520,1.396153846153846,893.0151174532266
103,1445,723,200,237,646,674,446,437,1766,194902,1.0205949656750573,624.4077193629175
104,1383,723,134,156,880,742,746,586,2664,437156,1.2730375426621159,948.6369168443741
105,1019,723,316,263,469,359,153,96,498,14688,1.59375,180.62391868188442
106,1508,723,76,163,904,751,828,588,2832,486864,1.4081632653061225,1015.543204398513
107,436,723,110,156,911,749,801,593,2788,474993,1.3507588532883643,996.6192853843437
108,191,32102,166,763,358,853,192,90,564,17280,2.1333333333333333,212.0471645648675
109,957,32102,158,686,400,910,242,224,932,54208,1.0803571428571428,329.75748664738455
110,128,32102,155,681,437,930,282,249,1062,70218,1.1325301204819278,376.19808611953357
111,465,32102,176,699,413,911,237,212,898,50244,1.1179245283018868,317.98270393214784
112,1480,20248,67,629,157,736,90,107,394,9630,0.8411214953271028,139.8177385026664
113,1109,20248,54,627,171,735,117,108,450,12636,1.0833333333333333,159.2262541165872
114,270,20248,62,634,163,738,101,104,410,10504,0.971153846153846,144.97241116847025
115,276,20248,113,685,154,734,41,49,180,2009,0.8367346938775511,63.89053137985315
116,329,20248,50,633,168,736,118,103,442,12154,1.145631067961165,156.6301375853319
117,1221,20248,71,625,173,686,102,61,326,6222,1.6721311475409837,118.84864324004712
118,988,20248,69,643,171,739,102,96,396,9792,1.0625,140.07141035914503
119,1362,20248,75,651,153,719,78,68,292,5304,1.1470588235294117,103.47946656221224
120,396,30546,48,1129,372,1329,324,200,1048,64800,1.62,380.7571404451924
121,1046,30546,126,1170,340,1317,214,147,722,31458,1.45578231292517,259.6247291765559
122,886,30546,47,1129,382,1341,335,212,1094,71020,1.5801886792452833,396.4454565258631
123,1594,30546,76,1137,378,1340,302,203,1010,61306,1.4876847290640394,363.88597115030416
124,1698,30546,134,1146,367,1322,233,176,818,41008,1.3238636363636365,292.00171232374646
125,1158,22107,39,534,271,649,232,115,694,26680,2.017391304347826,258.9382165691268
126,55,22107,45,538,270,649,225,111,672,24975,2.0270270270270268,250.89041432466087
127,547,22107,53,530,247,648,194,118,624,22892,1.6440677966101696,227.06827167175956
128,471,3449,60,790,604,1189,544,399,1886,217056,1.3634085213032578,674.6384216748999
129,242,3449,41,772,603,1182,562,410,1944,230420,1.3707317073170733,695.6608369025814
130,577,3449,63,806,604,1155,541,349,1780,188809,1.5501432664756447,643.8027648278625
131,1692,227,394,842,864,1319,470,477,1894,224190,0.9853249475890984,669.6484152150291
132,1351,227,303,911,734,1348,431,437,1736,188347,0.9862700228832952,613.7833493994441
133,1243,227,252,888,744,1374,492,486,1956,239112,1.0123456790123455,691.5634461132254
134,718,227,369,922,758,1142,389,220,1218,85580,1.768181818181818,446.90155515504756
135,831,227,216,841,829,1366,613,525,2276,321825,1.1676190476190476,807.0898339094601
136,1116,5142,199,635,558,1011,359,376,1470,134984,0.9547872340425532,519.862481816105
137,401,5142,165,659,579,1013,414,354,1536,146556,1.1694915254237288,544.7127683467683
138,886,5142,184,637,529,1025,345,388,1466,133860,0.8891752577319587,519.2003466870954
139,1149,7989,61,616,466,910,405,294,1398,119070,1.3775510204081634,500.4607876747188
140,1361,7989,503,598,704,765,201,167,736,33567,1.2035928143712575,261.3235542388018
141,1744,7989,40,594,472,926,432,332,1528,143424,1.3012048192771084,544.8375904799522
142,866,7989,532,594,697,845,165,251,832,41415,0.6573705179282868,300.37643050013094
143,265,7989,34,582,473,984,439,402,1682,176478,1.092039800995025,595.2520474555296
144,1084,7989,528,600,754,891,226,291,1034,65766,0.7766323024054983,368.4521678590045
145,161,7989,52,611,541,942,489,331,1640,161859,1.4773413897280967,590.4930143532606
146,712,7989,145,666,766,880,621,214,1670,132894,2.9018691588785046,656.8386407634679
147,78,18682,50,1068,205,1302,155,234,778,36270,0.6623931623931624,280.67953256338444
148,891,18682,38,1058,206,1287,168,229,794,38472,0.7336244541484717,284.01584462842914
149,1610,18682,50,1091,189,1299,139,208,694,28912,0.6682692307692307,250.16994223927063
150,229,17528,28,640,425,825,397,185,1164,73445,2.145945945945946,437.98858432612144
151,560,17528,62,633,395,811,333,178,1022,59274,1.8707865168539328,377.5884002455584
152,389,17528,41,667,154,809,113,142,510,16046,0.7957746478873241,181.47451611727746
153,457,17528,50,571,427,831,377,260,1274,98020,1.45,457.961788799022
154,737,17528,28,664,154,825,126,161,574,20286,0.7826086956521741,204.44314613114327
155,512,17528,317,637,428,828,111,191,604,21201,0.5811518324607329,220.91174708466727
156,1225,29504,80,824,518,1247,438,423,1722,185274,1.0354609929078014,608.9113235931814
157,932,29504,99,842,529,1262,430,420,1700,180600,1.0238095238095235,601.0823570859487
158,1115,29504,84,837,520,1239,436,402,1676,175272,1.0845771144278606,593.0430001273095
159,813,31194,53,717,568,1029,515,312,1654,160680,1.6506410256410255,602.137027594218
160,1508,31194,83,595,579,1060,496,465,1922,230640,1.0666666666666669,679.8830781833005
161,909,31194,155,612,602,1164,447,552,1998,246744,0.8097826086956522,710.2907855237881
162,1413,1476,199,530,419,804,220,274,988,60280,0.8029197080291971,351.3915195334116
163,1607,1476,159,504,502,844,343,340,1366,116620,1.008823529411765,482.95859035739284
164,1602,1476,158,537,504,842,346,305,1302,105530,1.1344262295081968,461.23854999338465
165,1601,1476,206,623,266,738,60,115,350,6900,0.5217391304347826,129.71121771072848
166,279,1476,187,493,500,822,313,329,1284,102977,0.9513677811550152,454.1035124286092
167,119,1476,202,561,441,783,239,222,922,53058,1.076576576576577,326.1977927577071
168,296,19910,195,1021,437,1126,242,105,694,25410,2.304761904761905,263.79727064547126
169,1504,19910,249,1066,305,1105,56,39,190,2184,1.4358974358974361,68.24221567329127
170,1148,19910,195,1045,438,1156,243,111,708,26973,2.189189189189189,267.15164233071823
171,1290,19910,185,1014,422,1179,237,165,804,39105,1.4363636363636365,288.7801932266131
172,295,19910,149,952,441,1142,292,190,964,55480,1.5368421052631578,348.3733629312092
173,763,19910,149,947,434,1181,285,234,1038,66690,1.2179487179487178,368.7560169000636
174,1262,2949,84,990,319,1139,235,149,768,35015,1.577181208053691,278.25527847643787
175,1601,2949,98,1004,133,1043,35,39,148,1365,0.8974358974358975,52.40229002629561
176,171,2949,128,1001,299,1117,171,116,574,19836,1.4741379310344829,206.6325240614362
177,1265,2949,99,1012,301,1113,202,101,606,20402,2.0,225.84286572747877
178,1116,2949,91,987,307,1141,216,154,740,33264,1.4025974025974026,265.2772134956186
179,787,2949,93,1012,239,1078,146,66,424,9636,2.212121212121212,160.22484201895784
180,391,2949,92,999,277,1116,185,117,604,21645,1.5811965811965811,218.89266776207924
181,1326,2949,84,988,145,1066,61,78,278,4758,0.7820512820512819,99.02019995940222
182,513,2949,97,1001,275,1138,178,137,630,24386,1.2992700729927007,224.61745257214542
183,1026,29298,34,407,182,639,148,232,760,34336,0.6379310344827587,275.18720900506986
184,314,29298,197,656,199,658,2,2,8,4,1.0,2.8284271247461903
185,831,29298,50,419,210,621,160,202,724,32320,0.7920792079207921,257.68973592287296
186,886,35973,90,914,127,978,37,64,202,2368,0.578125,73.92563831310488
187,1698,35973,87,915,125,976,38,61,198,2318,0.6229508196721312,71.8679344353238
188,119,35973,91,924,128,963,37,39,152,1443,0.9487179487179488,53.75872022286245
189,203,33435,169,273,767,768,598,495,2186,296010,1.2080808080808079,776.2918265703948
190,648,33435,54,286,821,839,767,553,2640,424151,1.3869801084990958,945.5675544349012
191,858,33435,34,195,929,881,895,686,3162,613970,1.30466472303207,1127.6617400621517
192,759,33435,17,197,910,900,893,703,3192,627779,1.2702702702702702,1136.5113285841016
193,1505,33435,89,249,617,835,528,586,2228,309408,0.9010238907849828,788.7838740745148
194,32,33435,20,273,783,832,763,559,2644,426517,1.364937388193202,945.8593975850745
195,258,33435,23,268,785,883,762,615,2754,468630,1.2390243902439024,979.2185660004615
196,1601,35978,381,773,418,809,37,36,146,1332,1.0277777777777777,51.62363799656123
197,1046,35978,78,758,193,841,115,83,396,9545,1.3855421686746987,141.8238343861849
198,798,35978,56,672,535,912,479,240,1438,114960,1.9958333333333331,535.7620740589987
199,279,35978,60,736,244,875,184,139,646,25576,1.3237410071942446,230.6013876801265
200,886,35978,63,741,203,839,140,98,476,13720,1.4285714285714286,170.89177862027185
201,1602,35978,51,630,535,916,484,286,1540,138424,1.6923076923076923,562.185022923948
202,119,35978,64,723,514,870,450,147,1194,66150,3.0612244897959178,473.4015209101044
203,886,27402,143,726,643,1031,500,305,1610,152500,1.639344262295082,585.6833615529811
204,504,27402,136,721,646,1038,510,317,1654,161670,1.6088328075709781,600.4906327329345
205,993,27402,124,752,374,950,250,198,896,49500,1.2626262626262623,318.91064579283017
206,61,27402,171,741,631,1019,460,278,1476,127880,1.6546762589928057,537.4793019270603
207,990,27402,126,741,660,1081,534,340,1748,181560,1.5705882352941176,633.0529203786995
208,1225,27402,129,737,663,1053,534,316,1700,168744,1.6898734177215189,620.4933520997627
209,1106,2528,103,403,393,641,290,238,1056,69020,1.2184873949579829,375.15863311404684
210,793,2528,89,390,403,664,314,274,1176,86036,1.1459854014598538,416.7397269279712
211,455,2528,126,406,404,606,278,200,956,55600,1.39,342.4675167077894
212,1305,27608,55,873,141,948,86,75,322,6450,1.1466666666666667,114.10959644131601
213,831,27608,66,875,152,935,86,60,292,5160,1.4333333333333331,104.86181383134664
214,538,27608,59,879,149,948,90,69,318,6210,1.3043478260869563,113.4063490286148
215,287,8948,449,399,913,822,464,423,1774,196272,1.0969267139479906,627.873394881484
216,525,8948,111,363,929,999,818,636,2908,520248,1.2861635220125789,1036.1563588570984
217,29,8948,361,460,933,702,572,242,1628,138424,2.363636363636364,621.0861453936966
218,753,8948,63,374,877,812,814,438,2504,356532,1.8584474885844748,924.3592375261903
219,71,8948,38,385,907,969,869,584,2906,507496,1.4880136986301369,1047.0038204323803
220,748,8948,494,497,901,759,407,262,1338,106634,1.5534351145038168,484.0382216313088
221,1181,8948,64,373,884,1017,820,644,2928,528080,1.2732919254658386,1042.6581414826242
222,1547,8948,101,398,793,1003,692,605,2594,418660,1.143801652892562,919.1784375190706
223,347,8948,533,417,831,787,298,370,1336,110260,0.8054054054054054,475.0831506168157
224,183,8948,46,339,939,1048,893,709,3204,633137,1.2595204513399154,1140.232432445245
225,1387,26008,42,566,357,776,315,210,1050,66150,1.5,378.5828839237189
226,205,26008,55,575,348,770,293,195,976,57135,1.5025641025641026,351.9573837838894
227,761,26008,56,564,255,746,199,182,762,36218,1.0934065934065933,269.675731203236
228,1508,26008,64,568,354,771,290,203,986,58870,1.4285714285714286,353.9901128562774
229,359,26008,89,582,226,678,137,96,466,13152,1.4270833333333333,167.28717822953436
230,581,26008,65,579,348,771,283,192,950,54336,1.4739583333333333,341.9839177505281
231,1663,19197,39,475,338,902,299,427,1452,127673,0.7002341920374707,521.2772774637314
232,1503,19197,28,521,291,914,263,393,1312,103359,0.6692111959287532,472.88264929049785
233,295,19197,41,495,333,902,292,407,1398,118844,0.7174447174447175,500.9121679496317
234,1558,19197,324,478,327,481,3,3,12,9,1.0,4.242640687119285
235,763,19197,34,481,324,911,290,430,1440,124700,0.6744186046511628,518.6520991955975
236,1202,19985,47,725,105,791,58,66,248,3828,0.8787878787878788,87.86353054595519
237,1618,19985,36,725,126,782,90,57,294,5130,1.5789473684210529,106.53168542738823
238,1290,19985,44,725,106,790,62,65,254,4030,0.953846153846154,89.8276126811795
239,1155,34340,53,683,459,1017,406,334,1480,135604,1.215568862275449,525.7299687101735
240,1304,34340,46,677,48,679,2,2,8,4,1.0,2.8284271247461903
241,918,34340,135,678,436,1002,301,324,1250,97524,0.9290123456790124,442.24088458666955
242,222,32736,82,391,412,637,330,246,1152,81180,1.3414634146341464,411.6017492674199
243,58,32736,67,377,382,584,315,207,1044,65205,1.5217391304347827,376.92704864469465
244,1046,32736,58,440,169,571,111,131,484,14541,0.8473282442748091,171.7032323516363
245,453,32736,49,408,403,615,354,207,1122,73278,1.710144927536232,410.07926063140525
246,455,32736,59,393,389,622,330,229,1118,75570,1.4410480349344978,401.6727523743676
247,934,32736,30,397,420,636,390,239,1258,93210,1.6317991631799162,457.4068211122348
248,884,32736,19,378,425,639,406,261,1334,105966,1.5555555555555556,482.6561923357039
249,1270,32736,99,391,420,643,321,252,1146,80892,1.2738095238095235,408.09925263347395
250,886,10820,32,659,35,661,3,2,10,6,1.5,3.605551275463989
251,1599,10820,32,659,34,661,2,2,8,4,1.0,2.8284271247461903
252,3,10820,32,659,35,661,3,2,10,6,1.5,3.605551275463989
253,1610,19253,73,1258,322,1421,249,163,824,40587,1.5276073619631902,297.6071235706565
254,240,19253,81,1262,314,1425,233,163,792,37979,1.4294478527607362,284.35541141325234
255,894,19253,74,1251,331,1427,257,176,866,45232,1.4602272727272727,311.4883625434504
256,1508,21593,74,849,351,1056,277,207,968,57339,1.3381642512077294,345.8005205317077
257,805,21593,65,833,317,1038,252,205,914,51660,1.2292682926829268,324.85227411855993
258,592,21593,67,828,353,1055,286,227,1026,64922,1.2599118942731278,365.1369606051954
259,909,8065,60,1137,569,1490,509,353,1724,179677,1.4419263456090652,619.4271547163556
260,1145,8065,84,1131,582,1577,498,446,1888,222108,1.116591928251121,668.5207551003933
261,494,8065,172,1141,606,1524,434,383,1634,166222,1.1331592689295042,578.8307179132773
262,906,8065,91,1105,562,1540,471,435,1812,204885,1.0827586206896551,641.1442895323953
263,1340,8065,279,1215,538,1483,259,268,1054,69412,0.9664179104477612,372.6996109469394
264,1508,8065,93,1121,318,1352,225,231,912,51975,0.9740259740259741,322.4686031228467
265,536,8065,235,1151,544,1466,309,315,1248,97335,0.9809523809523808,441.2550282999617
266,95,8065,44,1094,754,1609,710,515,2450,365650,1.3786407766990292,877.1117374656435
267,1389,8065,84,1120,576,1521,492,401,1786,197292,1.226932668329177,634.7164721353937
268,703,8065,122,1172,599,1536,477,364,1682,173628,1.3104395604395604,600.0208329716561
269,379,19632,49,776,1027,1445,978,669,3294,654282,1.4618834080717489,1184.9240481988709
270,1210,19632,84,737,1039,1441,955,704,3318,672320,1.3565340909090908,1186.4404746973191
271,1248,19632,978,1422,982,1426,4,4,16,16,1.0,5.656854249492381
272,1517,19632,366,823,858,1458,492,635,2254,312420,0.7748031496062993,803.2988236017777
273,1516,19632,277,711,1007,1455,730,744,2948,543120,0.9811827956989247,1042.3224069355892
274,380,19632,122,725,973,1453,851,728,3158,619528,1.168956043956044,1119.9040137440352
275,711,19632,212,865,1034,1451,822,586,2816,481692,1.4027303754266212,1009.4949232165559
276,1602,1136,345,791,744,1223,399,432,1662,172368,0.9236111111111112,588.0688735173798
277,924,1136,249,883,571,1120,322,237,1118,76314,1.358649789029536,399.8162077755228
278,1103,1136,281,862,806,1219,525,357,1764,187425,1.4705882352941178,634.8810912289009
279,1225,1136,288,925,794,1223,506,298,1608,150788,1.6979865771812082,587.2307893835268
280,880,1136,240,881,746,1210,506,329,1670,166474,1.5379939209726443,603.5536430177519
281,1101,1136,246,874,803,1279,557,405,1924,225585,1.3753086419753089,688.6755404397633
282,886,1136,287,909,748,1167,461,258,1438,118938,1.7868217054263569,528.2849609822335
283,517,9762,126,1136,146,1177,20,41,122,820,0.4878048780487805,45.617978911828175
284,1125,9762,108,1124,146,1185,38,61,198,2318,0.6229508196721312,71.8679344353238
285,1279,9762,102,1126,149,1182,47,56,206,2632,0.8392857142857143,73.10950690573696
286,641,9762,80,1115,173,1190,93,75,336,6975,1.24,119.47384651043926
287,748,9762,105,1128,144,1172,39,44,166,1716,0.8863636363636364,58.7962583843564
288,1231,9762,113,1127,153,1182,40,55,190,2200,0.7272727272727273,68.00735254367721
289,1277,9762,106,1131,149,1189,43,58,202,2494,0.7413793103448276,72.20110802473879
290,421,9762,108,1128,156,1180,48,52,200,2496,0.9230769230769232,70.76722405181653
291,1454,26645,76,460,751,933,675,473,2296,319275,1.427061310782241,824.2293370173134
292,1729,26645,77,511,789,966,712,455,2334,323960,1.5648351648351648,844.9668632555954
293,858,26645,56,437,473,917,417,480,1794,200160,0.86875,635.83724332568
294,643,26645,79,442,832,966,753,524,2554,394572,1.4370229007633588,917.3794198694453
295,1341,26645,93,455,804,943,711,488,2398,346968,1.4569672131147542,862.3601335868907
296,761,26645,314,490,555,788,241,298,1078,71818,0.8087248322147651,383.2557892582968
297,149,26645,159,447,623,961,464,514,1956,238496,0.9027237354085604,692.4536085543926
298,860,26645,784,448,788,452,4,4,16,16,1.0,5.656854249492381
299,61,28770,212,892,706,1511,494,619,2226,305786,0.7980613893376414,791.9577008906473
300,886,28770,56,912,700,1424,644,512,2312,329728,1.2578125,822.7271722752324
301,1225,28770,81,879,652,1542,571,663,2468,378573,0.861236802413273,874.9914285294457
302,656,24880,67,800,351,880,284,80,728,22720,3.55,295.05253769456044
303,1307,24880,46,801,357,893,311,92,806,28612,3.3804347826086962,324.32237048961025
304,829,24880,39,779,367,894,328,115,886,37720,2.8521739130434782,347.57589099360735
305,717,24880,44,793,363,873,319,80,798,25520,3.9875,328.8783969797956
306,379,24880,56,806,354,871,298,65,726,19370,4.584615384615383,305.00655730656024
307,1028,24880,56,767,367,943,311,176,974,54736,1.7670454545454546,357.3471701301131
308,1085,24880,48,769,359,943,311,174,970,54114,1.7873563218390804,356.36638449775256
309,1182,20615,108,656,461,852,353,196,1098,69188,1.8010204081632653,403.7635446644484
310,70,20615,66,634,530,1115,464,481,1890,223184,0.9646569646569648,668.3240232102988
311,120,20615,62,634,500,1090,438,456,1788,199728,0.9605263157894736,632.281582841063
312,850,20615,65,631,506,1124,441,493,1868,217413,0.8945233265720081,661.4605052457781
313,853,20615,108,628,401,838,293,210,1006,61530,1.3952380952380952,360.4843963336
314,19,20615,79,653,547,1100,468,447,1830,209196,1.046979865771812,647.1730834946707
315,1615,20615,107,640,499,922,392,282,1348,110544,1.3900709219858156,482.895433815645
316,125,20615,109,620,421,899,312,279,1182,87048,1.118279569892473,418.5510721524913
317,575,20615,99,656,538,1043,439,387,1652,169893,1.1343669250645996,585.2264518970413
318,1329,20615,89,628,523,1099,434,471,1810,204414,0.921443736730361,640.4662364246846
319,1721,20615,55,605,471,1050,416,445,1722,185120,0.9348314606741572,609.1641814814787
320,1652,20615,102,637,538,1078,436,441,1754,192276,0.9886621315192744,620.1427255076044
321,891,19707,21,569,229,717,208,148,712,30784,1.4054054054054057,255.2802381697416
322,1185,19707,24,575,169,718,145,143,576,20735,1.013986013986014,203.6516633862832
323,800,19707,33,580,189,710,156,130,572,20280,1.2,203.06649157357302
324,1592,17436,95,1065,205,1239,110,174,568,19140,0.632183908045977,205.854317418897
325,768,17436,64,1082,283,1231,219,149,736,32631,1.4697986577181208,264.8811054039151
326,1684,17436,59,1067,273,1232,214,165,758,35310,1.2969696969696969,270.22398117117586
327,853,20624,240,197,630,627,390,430,1640,167700,0.9069767441860463,580.5170109479997
328,1182,20624,238,246,670,649,432,403,1670,174096,1.0719602977667493,590.7901488684455
329,70,20624,208,193,648,640,440,447,1774,196680,0.9843400447427292,627.2232457426941
330,259,18847,47,341,363,478,316,137,906,43292,2.3065693430656933,344.41980198589044
331,379,18847,29,242,496,570,467,328,1590,153176,1.423780487804878,570.6776673394536
332,551,18847,90,330,367,531,277,201,956,55677,1.3781094527363185,342.24260401066374
333,1253,18847,47,306,399,539,352,233,1170,82016,1.5107296137339057,422.12912716371517
334,868,18847,24,221,629,678,605,457,2124,276485,1.323851203501094,758.204457913563
335,1097,18847,11,255,459,619,448,364,1624,163072,1.2307692307692308,577.2347875864725
336,1033,18847,61,343,354,471,293,128,842,37504,2.2890625,319.7389560250674
337,971,23811,160,560,857,1049,697,489,2372,340833,1.425357873210634,851.4282118887064
338,1500,23811,214,635,785,1066,571,431,2004,246101,1.3248259860788862,715.4033827149548
339,140,23811,190,576,816,1043,626,467,2186,292342,1.3404710920770877,781.0025608152639
340,137,5692,32,561,179,700,147,139,572,20433,1.0575539568345325,202.3116407921205
341,967,5692,47,568,171,687,124,119,486,14756,1.0420168067226891,171.86331778480246
342,809,5692,37,562,196,702,159,140,598,22260,1.1357142857142857,211.85136298829894
343,446,8126,308,311,714,963,406,652,2116,264712,0.6226993865030674,768.0755171205498
344,265,8126,163,307,821,961,658,654,2624,430332,1.0061162079510704,927.7284085334458
345,866,8126,335,400,802,772,467,372,1678,173724,1.2553763440860215,597.0535989339651
346,1031,8126,213,316,741,921,528,605,2266,319440,0.8727272727272727,803.0
347,1361,8126,247,322,882,795,635,473,2216,300355,1.342494714587738,791.8042687432293
348,1686,8126,205,331,716,938,511,607,2236,310177,0.8418451400329492,793.4544725439513
349,1084,8126,310,305,691,931,381,626,2014,238506,0.6086261980830671,732.8280835230047
350,213,8126,123,319,913,963,790,644,2868,508760,1.2267080745341614,1019.2330449902024
351,1685,8126,257,307,829,688,572,381,1906,217932,1.5013123359580052,687.2735990855462
352,1394,8126,310,345,702,944,392,599,1982,234808,0.654424040066778,715.8666076860968
353,161,8126,167,309,829,967,662,658,2640,435596,1.006079027355623,933.3852366520482
354,1139,31313,50,432,335,732,285,300,1170,85500,0.95,413.7934267240116
355,1508,31313,35,460,396,728,361,268,1258,96748,1.3470149253731345,449.60538253005825
356,903,31313,85,435,395,659,310,224,1068,69440,1.3839285714285714,382.4604554721965
360,1540,5066,25,701,27,702,2,1,6,2,2.0,2.23606797749979
366,842,27957,151,687,518,913,367,226,1186,82942,1.6238938053097345,431.00464034624963
367,61,27957,195,706,507,903,312,197,1018,61464,1.583756345177665,368.9891597323694
368,66,27957,193,718,517,909,324,191,1030,61884,1.6963350785340314,376.10769734213096
369,177,12283,96,413,729,824,633,411,2088,260163,1.54014598540146,754.7251155222012
370,1172,12283,130,386,668,844,538,458,1992,246404,1.1746724890829694,706.5465306687169
371,621,12283,95,408,510,830,415,422,1674,175130,0.9834123222748816,591.8690733599789
372,993,12283,118,431,493,732,375,301,1352,112875,1.2458471760797345,480.8596468825389
373,1469,12283,108,380,714,825,606,445,2102,269670,1.3617977528089888,751.8384134905585
374,66,12283,118,400,729,843,611,443,2108,270673,1.3792325056433408,754.6986153425751
375,1359,507,216,225,983,864,767,639,2812,490113,1.2003129890453834,998.3035610474401
376,1585,507,252,237,861,807,609,570,2358,347130,1.068421052631579,834.134881179297
377,877,507,186,237,980,847,794,610,2808,484340,1.3016393442622949,1001.2671971057476
378,1633,507,912,235,916,238,4,3,14,12,1.3333333333333333,5.0
379,555,507,152,301,795,812,643,511,2308,328573,1.2583170254403129,821.3221049016031
380,984,507,238,267,961,828,723,561,2568,405603,1.288770053475936,915.1229425601787
381,604,507,258,220,798,841,540,621,2322,335340,0.8695652173913043,822.9465353229212
382,1750,507,184,309,879,716,695,407,2204,282865,1.7076167076167077,805.4030047125476
383,1694,507,260,223,781,866,521,643,2328,335003,0.8102643856920684,827.5808117640235
384,153,28171,24,473,307,761,283,288,1142,81504,0.9826388888888888,403.77345133131274
385,498,28171,30,477,380,748,350,271,1242,94850,1.2915129151291511,442.6522337004525
386,214,28171,42,483,369,753,327,270,1194,88290,1.2111111111111108,424.062495394252
387,379,28171,32,469,313,758,281,289,1140,81209,0.9723183391003459,403.09056054440174
388,266,28171,28,468,365,766,337,298,1270,100426,1.1308724832214765,449.8588667571197
389,1458,28171,43,479,318,762,275,283,1116,77825,0.9717314487632508,394.60613274504493
390,1743,28171,24,463,297,741,273,278,1102,75894,0.9820143884892086,389.6318775459729
391,157,28171,23,470,343,760,320,290,1220,92800,1.1034482758620692,431.8564576337837
392,1585,28171,26,472,327,753,301,281,1164,84581,1.0711743772241993,411.7790669764552
393,340,28239,224,905,465,1242,241,337,1156,81217,0.7151335311572701,414.30664971733194
394,1719,28239,199,898,548,1290,349,392,1482,136808,0.8903061224489796,524.8475969269556
395,638,28239,164,933,578,1291,414,358,1544,148212,1.1564245810055866,547.3207469117172
396,1508,23018,49,1101,239,1264,190,163,706,30970,1.1656441717791408,250.3377718203947
397,1500,23018,50,1105,236,1256,186,151,674,28086,1.2317880794701987,239.57671005337727
398,300,23018,43,1099,256,1266,213,167,760,35571,1.2754491017964071,270.66215102965543
399,1562,23018,46,1106,253,1261,207,155,724,32085,1.335483870967742,258.6000773395089
400,761,23018,43,1100,222,1245,179,145,648,25955,1.2344827586206897,230.36058690670154
401,972,4192,28,797,743,1071,715,274,1978,195910,2.6094890510948905,765.7029450119675
402,1506,4192,48,761,742,1101,694,340,2068,235960,2.041176470588235,772.8104554158155
403,1562,4192,42,776,734,1101,692,325,2034,224900,2.129230769230769,764.5188029080776
404,1698,7884,168,744,685,1021,517,277,1588,143209,1.8664259927797835,586.5304766165182
405,387,7884,183,743,494,1035,311,292,1206,90812,1.0650684931506849,426.5969995206249
406,401,7884,140,767,650,1048,510,281,1582,143310,1.8149466192170816,582.289446924809
407,273,27742,14,237,575,710,561,473,2068,265353,1.186046511627907,733.7915235269484
408,1225,27742,33,278,586,700,553,422,1950,233366,1.3104265402843602,695.6241801432725
409,452,27742,376,265,506,474,130,209,678,27170,0.6220095693779905,246.13207836444238
410,1603,27742,9,240,563,704,554,464,2036,257056,1.1939655172413792,722.6423735154201
411,393,27742,33,242,545,708,512,466,1956,238592,1.098712446351931,692.314957226839
412,1311,27742,442,257,445,259,3,2,10,6,1.5,3.605551275463989
413,1033,2869,28,506,53,527,25,21,92,525,1.1904761904761905,32.64965543462902
414,823,2869,28,506,52,526,24,20,88,480,1.2,31.240998703626616
415,1407,2869,28,506,52,525,24,19,86,456,1.263157894736842,30.610455730027933
416,1239,10913,39,582,135,633,96,51,294,4896,1.8823529411764703,108.70602559196064
417,805,10913,31,570,134,634,103,64,334,6592,1.609375,121.26417442921878
418,596,10913,31,592,131,619,100,27,254,2700,3.703703703703704,103.58088626768937
419,1663,10913,35,579,135,629,100,50,300,5000,2.0,111.80339887498948
420,496,13610,82,1126,991,1551,909,425,2668,386325,2.138823529411765,1003.4470588924959
421,161,13610,65,1088,649,1589,584,501,2170,292584,1.1656686626746506,769.452402686482
422,1308,13610,51,1062,644,1584,593,522,2230,309546,1.136015325670498,790.0208857998629
423,654,13610,604,1098,987,1530,383,432,1630,165456,0.8865740740740741,577.3326597378673
424,917,13610,594,1047,979,1474,385,427,1624,164395,0.9016393442622952,574.9382575546699
425,449,13610,76,1094,936,1554,860,460,2640,395600,1.8695652173913044,975.2948272189287
426,101,13610,83,1104,997,1150,914,46,1920,42044,19.869565217391305,915.1568171630478
427,315,13610,126,1111,939,1586,813,475,2576,386175,1.7115789473684209,941.5912064160327
428,1739,13610,62,1029,994,1603,932,574,3012,534968,1.6236933797909407,1094.5775440780794
429,552,13610,68,1078,978,1572,910,494,2808,449540,1.8421052631578947,1035.4400030904735
430,1466,13610,39,1061,995,1639,956,578,3068,552568,1.6539792387543253,1117.148154901578
431,831,13610,54,1071,990,1586,936,515,2902,482040,1.81747572815534,1068.3262610270328
432,1045,6244,194,884,451,1130,257,246,1006,63222,1.0447154471544715,355.75975039343615
433,1699,6244,189,874,453,1145,264,271,1070,71544,0.9741697416974171,378.3345080745345
434,1473,6244,147,874,430,1171,283,297,1160,84051,0.9528619528619529,410.24139235333143
435,909,17671,66,971,458,1262,392,291,1366,114072,1.3470790378006874,488.2058991859889
436,531,17671,76,948,488,1278,412,330,1484,135960,1.2484848484848483,527.8674075939904
437,1022,17671,94,995,472,1271,378,276,1308,104328,1.3695652173913044,468.03845995815345
438,957,32958,85,739,334,951,249,212,922,52788,1.1745283018867925,327.0244639166923
439,128,32958,40,730,354,960,314,230,1088,72220,1.3652173913043475,389.22487073669896
440,1132,32958,100,738,343,956,243,218,922,52974,1.1146788990825691,326.45520366506645
441,191,32958,76,813,325,940,249,127,752,31623,1.9606299212598424,279.5174413162799
442,1548,32958,74,748,314,951,240,203,886,48720,1.1822660098522169,314.33898899118446
443,952,32958,124,757,303,927,179,170,698,30430,1.0529411764705885,246.86230980042296
444,279,1425,61,806,163,876,102,70,344,7140,1.457142857142857,123.70933675353692
445,1046,1425,80,809,141,877,61,68,258,4148,0.8970588235294118,91.35097153287424
446,886,1425,83,818,149,872,66,54,240,3564,1.2222222222222223,85.27602242131137
447,970,14459,192,489,538,845,346,356,1404,123176,0.9719101123595506,496.4393215691118
448,583,14459,242,536,340,632,98,96,388,9408,1.0208333333333333,137.18600511714013
449,1562,14459,118,435,479,837,361,402,1526,145122,0.8980099502487562,540.3008421240893
450,1016,14459,208,478,665,792,457,314,1542,143498,1.4554140127388535,554.477231272845
451,1076,14459,53,532,142,799,89,267,712,23763,0.3333333333333333,281.44271175498574
452,586,14459,243,509,478,840,235,331,1132,77785,0.7099697885196374,405.93841897509526
453,903,14459,174,493,477,763,303,270,1146,81810,1.1222222222222222,405.8435659216492
454,71,8955,55,686,119,766,64,80,288,5120,0.8,102.44998779892558
455,287,8955,45,683,135,761,90,78,336,7020,1.1538461538461535,119.09659944767525
456,1181,8955,49,689,139,766,90,77,334,6930,1.1688311688311688,118.44407963254221
457,748,8955,44,693,95,737,51,44,190,2244,1.1590909090909092,67.35725647619564
458,941,8955,50,688,155,771,105,83,376,8715,1.2650602409638554,133.843191832831
459,469,8955,49,691,130,760,81,69,300,5589,1.173913043478261,106.4048871058092
460,573,8955,46,688,145,763,99,75,348,7425,1.32,124.2014492669067
461,29,8955,50,692,91,734,41,42,166,1722,0.9761904761904762,58.69412236331676
462,1543,8955,49,685,148,760,99,75,348,7425,1.32,124.2014492669067
463,1311,492,209,1104,210,1105,1,1,4,1,1.0,1.4142135623730951
464,886,492,104,1093,231,1227,127,134,522,17018,0.9477611940298508,184.6212338816963
465,60,492,90,1089,255,1229,165,140,610,23100,1.1785714285714286,216.390850083824
466,1340,6821,81,1052,299,1270,218,218,872,47524,1.0,308.2985565973347
467,361,6821,80,1035,407,1355,327,320,1294,104640,1.021875,457.5248627123995
468,195,6821,91,1052,431,1349,340,297,1274,100980,1.144781144781145,451.45210155674323
469,1389,6821,69,1018,428,1355,359,337,1392,120983,1.0652818991097923,492.3921201644072
470,482,6821,67,1002,348,1339,281,337,1236,94697,0.8338278931750742,438.78240621064106
471,782,10532,105,601,878,1230,773,629,2804,486217,1.228934817170111,996.5791488888376
472,886,10532,117,570,872,1232,755,662,2834,499810,1.1404833836858006,1004.1259881110537
473,1326,10532,182,706,645,1140,463,434,1794,200942,1.066820276497696,634.606177089382
474,3,10532,194,589,885,1266,691,677,2736,467807,1.020679468242245,967.372730647293
475,1599,10532,188,614,758,1195,570,581,2302,331170,0.9810671256454389,813.9170719428362
476,1696,10532,161,579,877,1252,716,673,2778,481868,1.063893016344725,982.6418472668463
477,699,18454,76,1011,231,1156,155,145,600,22475,1.0689655172413792,212.24985276791125
478,1240,18454,50,990,206,1191,156,201,714,31356,0.7761194029850746,254.4346674492295
479,1074,18454,207,1007,209,1009,2,2,8,4,1.0,2.8284271247461903
480,766,18454,83,1003,190,1182,107,179,572,19153,0.5977653631284916,208.54256160314134
481,367,18454,71,992,221,1136,150,144,588,21600,1.0416666666666667,207.9326814139615
482,853,22206,111,751,626,1250,515,499,2028,256985,1.0320641282565128,717.0955305954709
483,330,22206,121,756,624,1287,503,531,2068,267093,0.9472693032015066,731.4164340510814
484,1182,22206,150,803,670,1271,520,468,1976,243360,1.1111111111111112,699.5884504478329
485,125,22206,229,769,626,1278,397,509,1812,202073,0.7799607072691552,645.5152980371573
486,338,22206,290,874,568,1068,278,194,944,53932,1.4329896907216495,338.9985250705377
487,1188,22206,172,790,592,1291,420,501,1842,210420,0.8383233532934131,653.7591299553682
488,1598,15382,45,290,660,694,615,404,2038,248460,1.5222772277227723,735.8267459123784
489,785,15382,138,316,621,702,483,386,1738,186438,1.2512953367875648,618.2920022125468
490,1117,15382,31,285,642,711,611,426,2074,260286,1.4342723004694835,744.8469641476697
491,903,2081,50,233,285,395,235,162,794,38070,1.4506172839506173,285.4277491765648
492,365,2081,73,249,302,479,229,230,918,52670,0.9956521739130436,324.56278283253613
493,42,2081,52,241,399,512,347,271,1236,94037,1.2804428044280445,440.2839992550263
494,761,2081,70,255,402,507,332,252,1168,83664,1.3174603174603174,416.8069097315926
495,582,2081,63,230,366,460,303,230,1066,69690,1.317391304347826,380.4063616713054
496,204,4033,48,600,347,803,299,203,1004,60697,1.4729064039408868,361.4000553403389
497,1389,4033,30,604,327,767,297,163,920,48411,1.8220858895705518,338.7890198929121
498,972,4033,51,606,334,783,283,177,920,50091,1.5988700564971752,333.79334924470857
499,1562,4033,40,604,354,813,314,209,1046,65626,1.5023923444976075,377.19623540008985
500,1342,4033,35,602,341,806,306,204,1020,62424,1.5,367.7662300973269
501,1506,4033,82,603,340,806,258,203,922,52374,1.270935960591133,328.28798333170835
502,1565,11735,43,755,73,776,30,21,102,630,1.4285714285714286,36.61966684720111
503,909,11735,42,752,71,773,29,21,100,609,1.380952380952381,35.805027579936315
504,1508,11735,42,752,59,779,17,27,88,459,0.6296296296296297,31.906112267087632
505,1044,30098,60,907,345,1142,285,235,1040,66975,1.2127659574468086,369.39139134527755
506,990,30098,92,897,311,1100,219,203,844,44457,1.0788177339901477,298.6134625230417
507,62,30098,95,904,309,1090,214,186,800,39804,1.1505376344086022,283.53483031190365
508,1441,29675,68,550,337,790,269,240,1018,64560,1.1208333333333331,360.50104022041324
509,1068,29675,39,573,343,749,304,176,960,53504,1.7272727272727273,351.2719744016024
510,1731,29675,78,565,353,817,275,252,1054,69300,1.0912698412698412,373.0
511,252,29675,111,592,326,751,215,159,748,34185,1.3522012578616351,267.4060582709375
512,1453,29675,34,579,336,850,302,271,1146,81842,1.1143911439114391,405.7647101461634
513,531,29675,105,555,306,730,201,175,752,35175,1.1485714285714286,266.50703555441083
514,1219,9893,32,532,46,542,14,10,48,140,1.4,17.204650534085253
515,886,9893,32,531,46,542,14,11,50,154,1.2727272727272727,17.804493814764857
516,783,9893,32,532,41,542,9,10,38,90,0.9,13.45362404707371
517,1416,17171,77,431,950,1070,873,639,3024,557847,1.3661971830985915,1081.8733752154178
518,503,17171,35,380,924,1122,889,742,3262,659638,1.19811320754717,1157.9658889621921
519,399,17171,23,364,1018,1133,995,769,3528,765155,1.2938881664499349,1257.5317093417566
520,1708,17171,43,384,989,1109,946,725,3342,685850,1.3048275862068963,1191.8645057220222
521,1723,19,27,559,112,727,85,168,506,14280,0.5059523809523809,188.27904822364064
522,141,19,34,564,119,729,85,165,500,14025,0.5151515151515151,185.60711193270586
523,903,19,28,559,113,721,85,162,494,13770,0.5246913580246914,182.94534703019914
524,502,7581,19,484,115,535,96,51,294,4896,1.8823529411764703,108.70602559196064
525,66,7581,19,484,114,535,95,51,292,4845,1.862745098039216,107.82393055347222
526,1698,7581,18,483,116,537,98,54,304,5292,1.8148148148148149,111.89280584559492
527,1087,5361,32,264,529,656,497,392,1778,194824,1.2678571428571428,632.9873616431848
528,313,5361,24,264,536,653,512,389,1802,199168,1.3161953727506426,643.0124415592594
529,1745,5361,101,317,493,586,392,269,1322,105448,1.4572490706319703,475.4208661806926
530,546,5361,10,257,548,657,538,400,1876,215200,1.345,670.4058472298701
531,1357,5361,39,275,524,653,485,378,1726,183330,1.283068783068783,614.9056838247635
532,873,5361,17,260,545,653,528,393,1842,207504,1.3435114503816794,658.2043755551919
533,1396,5361,156,256,533,645,377,389,1532,146653,0.9691516709511568,541.7102546564907
534,210,5361,170,325,201,362,31,37,136,1147,0.8378378378378378,48.27007354458868
535,827,5361,151,262,548,609,397,347,1488,137759,1.1440922190201728,527.274122255208
536,938,16288,437,357,819,673,382,316,1396,120712,1.2088607594936709,495.7620396924315
537,1046,16288,621,391,737,569,116,178,588,20648,0.651685393258427,212.46176126540982
538,67,16288,252,366,808,687,556,321,1754,178476,1.7320872274143302,642.0101245307585
539,1478,16288,380,429,765,763,385,334,1438,128590,1.1526946107784428,509.68715895144936
540,1606,16288,424,349,850,617,426,268,1388,114168,1.5895522388059702,503.2891812864648
541,1698,16288,601,355,721,580,120,225,690,27000,0.5333333333333333,255.0
542,909,12545,67,662,187,731,120,69,378,8280,1.7391304347826086,138.42326394071193
543,142,12545,80,677,114,703,34,26,120,884,1.3076923076923077,42.80186911806539
544,968,12545,55,660,167,728,112,68,360,7616,1.6470588235294117,131.0267148332736
545,1672,12545,55,661,164,727,109,66,350,7194,1.6515151515151516,127.4244874425634
546,433,12545,71,669,154,725,83,56,278,4648,1.4821428571428572,100.12492197250393
547,1389,12545,64,664,161,736,97,72,338,6984,1.3472222222222223,120.80149005703531
548,963,12545,72,673,152,718,80,45,250,3600,1.7777777777777777,91.7877987534291
549,650,12545,51,642,164,738,113,96,418,10848,1.1770833333333333,148.27339613025663
550,1668,12545,59,664,153,722,94,58,304,5452,1.6206896551724137,110.45361017187261
551,177,11612,95,1073,355,1321,260,248,1016,64480,1.0483870967741935,359.310450724718
552,1470,11612,404,1070,635,1311,231,241,944,55671,0.95850622406639,333.8292976956936
553,1469,11612,70,1050,360,1354,290,304,1188,88160,0.9539473684210528,420.1380725428249
554,66,11612,59,1047,664,1337,605,290,1790,175450,2.086206896551724,670.9135562797937
555,1411,11612,48,1048,391,1350,343,302,1290,103586,1.1357615894039734,457.00437634666037
556,993,11612,398,1047,658,1284,260,237,994,61620,1.0970464135021096,351.8081863743367
557,358,4593,141,455,504,760,363,305,1336,110715,1.1901639344262296,474.12445623485826
558,294,4593,162,403,586,784,424,381,1610,161544,1.1128608923884515,570.0324552163675
559,819,4593,156,412,527,776,371,364,1470,135044,1.0192307692307692,519.747053863704
560,1144,4593,173,408,622,769,449,361,1620,162089,1.2437673130193905,576.1267221714334
561,1389,4593,126,425,496,820,370,395,1530,146150,0.9367088607594936,541.2254613375095
562,1487,34796,46,441,157,512,111,71,364,7881,1.5633802816901408,131.76494222667878
563,345,34796,61,444,139,510,78,66,288,5148,1.181818181818182,102.17631819555841
564,571,34796,59,439,163,515,104,76,360,7904,1.368421052631579,128.80993750483694
565,1422,34796,42,432,216,527,174,95,538,16530,1.831578947368421,198.2447981663075
566,20,34796,53,443,242,533,189,90,558,17010,2.1,209.33466029303412
567,1186,34796,52,430,164,529,112,99,422,11088,1.1313131313131313,149.4824404403407
568,408,34796,58,427,243,525,185,98,566,18130,1.8877551020408163,209.35376758014172
569,352,34796,64,448,127,499,63,51,228,3213,1.2352941176470589,81.05553651663777
570,991,17130,63,737,116,800,53,63,232,3339,0.8412698412698413,82.3286098510111
571,399,17130,36,731,124,814,88,83,342,7304,1.0602409638554218,120.96693763173474
572,503,17130,39,733,148,820,109,87,392,9483,1.2528735632183907,139.46325680981354
573,1684,22771,272,458,625,679,353,221,1148,78013,1.5972850678733033,416.473288459176
574,1295,22771,242,304,711,691,469,387,1712,181503,1.2118863049095607,608.0542738933754
575,55,22771,272,474,574,683,302,209,1022,63118,1.4449760765550241,367.26693289758606
576,1400,22771,545,332,696,595,151,263,828,39713,0.5741444866920152,303.2655601943617
577,1357,22771,252,349,717,695,465,346,1622,160890,1.3439306358381502,579.604175278267
578,100,22771,47,249,818,789,771,540,2622,416340,1.4277777777777778,941.297508761178
579,1396,4682,36,796,67,819,31,23,108,713,1.3478260869565215,38.600518131237564
580,1401,4682,45,799,66,814,21,15,72,315,1.4,25.80697580112788
581,1254,4682,35,795,67,819,32,24,112,768,1.3333333333333333,40.0
582,873,4682,35,796,67,819,32,23,110,736,1.391304347826087,39.408120990476064
583,100,4682,35,795,67,818,32,23,110,736,1.391304347826087,39.408120990476064
584,1404,4682,35,795,66,819,31,24,110,744,1.2916666666666667,39.20459156782532
585,71,8647,126,709,641,1102,515,393,1816,202395,1.3104325699745547,647.8225065556152
586,29,8647,188,810,558,1086,370,276,1292,102120,1.3405797101449275,461.6015597893924
587,748,8647,216,730,630,940,414,210,1248,86940,1.9714285714285715,464.2154672132328
588,573,8647,109,710,671,1109,562,399,1922,224238,1.4085213032581454,689.2350832625978
589,857,15732,253,633,529,854,276,221,994,60996,1.248868778280543,353.57743140647426
590,1347,15732,214,622,524,835,310,213,1046,66030,1.4553990610328638,376.12364988125915
591,305,15732,48,617,357,1024,309,407,1432,125763,0.7592137592137592,511.00880618635136
592,537,15732,308,668,386,774,78,106,368,8268,0.7358490566037735,131.60547101089682
593,965,15732,182,610,521,946,339,336,1350,113904,1.0089285714285714,477.3017913228485
594,651,15732,87,618,473,886,386,268,1308,103448,1.4402985074626866,469.91488591020396
595,88,15732,248,639,511,899,263,260,1046,68380,1.0115384615384615,369.8229306032821
596,755,15732,36,615,578,1029,542,414,1912,224388,1.3091787439613527,682.0263924512012
597,379,1542,173,827,367,1159,194,332,1052,64408,0.5843373493975904,384.5256818471297
598,1690,1542,172,868,471,1086,299,218,1034,65182,1.3715596330275228,370.0337822415678
599,831,1542,159,788,445,1161,286,373,1318,106678,0.7667560321715817,470.02659499224086
600,1021,5236,35,665,339,858,304,193,994,58672,1.5751295336787563,360.0902664610639
601,1508,5236,37,643,178,846,141,203,688,28623,0.6945812807881774,247.1639132235934
602,819,5236,36,647,343,870,307,223,1060,68461,1.3766816143497758,379.44433056773954
603,969,5236,130,696,312,827,182,131,626,23842,1.3893129770992367,224.24317157942625
604,696,5236,47,657,334,809,287,152,878,43624,1.8881578947368418,324.7660696562989
605,245,18175,70,965,191,1020,121,55,352,6655,2.2,132.9135057095403
606,254,18175,68,962,188,1030,120,68,376,8160,1.7647058823529411,137.92751719653333
607,1147,18175,77,958,183,1022,106,64,340,6784,1.65625,123.82245353731285
608,480,18175,120,958,188,1016,68,58,252,3944,1.1724137931034482,89.37561188601732
609,916,6109,70,1088,393,1501,323,413,1472,133399,0.7820823244552058,524.3071618812774
610,1353,6109,77,1158,452,1597,375,439,1628,164625,0.8542141230068337,577.3612387405307
611,1092,6109,87,1113,446,1561,359,448,1614,160832,0.8013392857142857,574.0949398836398
612,1097,6109,47,1114,443,1584,396,470,1732,186120,0.8425531914893617,614.5860395420644
613,1694,6109,103,1187,440,1587,337,400,1474,134800,0.8425,523.0382395198271
614,1399,6109,142,1190,372,1445,230,255,970,58650,0.9019607843137256,343.4020966738555
615,1203,6853,220,389,636,826,416,437,1706,181792,0.9519450800915332,603.3448433524562
616,1389,6853,217,365,600,779,383,414,1594,158562,0.92512077294686,563.9902481426429
617,195,6853,256,386,555,838,299,452,1502,135148,0.6615044247787609,541.9455692225927
618,1129,15290,54,875,83,902,29,27,112,783,1.0740740740740742,39.6232255123179
619,1328,15290,54,873,82,903,28,30,116,840,0.9333333333333332,41.036569057366385
620,525,15290,53,873,83,902,30,29,118,870,1.0344827586206895,41.72529209005013
621,286,15290,56,884,77,899,21,15,72,315,1.4,25.80697580112788
622,410,15290,53,873,87,900,34,27,122,918,1.2592592592592593,43.41658669218482
623,291,20312,121,550,331,698,210,148,716,31080,1.4189189189189189,256.9124364447934
624,234,20312,82,519,315,712,233,193,852,44969,1.2072538860103628,302.5524747874325
625,71,20312,107,543,307,829,200,286,972,57200,0.6993006993006993,348.99283660270163
626,854,20312,120,500,330,750,210,250,920,52500,0.84,326.49655434629017
627,852,20312,73,455,558,849,485,394,1758,191090,1.230964467005076,624.8687862263565
628,523,20312,22,448,552,858,530,410,1880,217300,1.2926829268292683,670.0746227100382
629,843,20312,57,511,295,759,238,248,972,59024,0.9596774193548387,343.7266355696049
630,351,20312,128,598,184,636,56,38,188,2128,1.4736842105263157,67.67569726275453
631,833,24081,95,948,249,1088,154,140,588,21560,1.1,208.12496246245908
632,611,24081,102,941,253,1094,151,153,608,23103,0.9869281045751634,214.96511344867102
633,119,24081,83,937,248,1083,165,146,622,24090,1.1301369863013702,220.32022149589446
634,387,24081,63,931,256,1148,193,217,820,41881,0.8894009216589862,290.410054922346
635,1700,24081,78,939,252,1076,174,137,622,23838,1.27007299270073,221.46105752479374
636,620,24081,62,927,254,1089,192,162,708,31104,1.1851851851851851,251.21305698549986
637,501,24081,51,951,240,1058,189,107,592,20223,1.766355140186916,217.18655575334307
638,1440,31435,73,1074,251,1256,178,182,720,32396,0.978021978021978,254.57415422622933
639,255,31435,63,1062,262,1263,199,201,800,39999,0.9900497512437813,282.8462479864281
640,1508,31435,81,1096,253,1258,172,162,668,27864,1.0617283950617284,236.2794955132586
641,32,31435,87,1081,267,1269,180,188,736,33840,0.9574468085106383,260.27677575995904
642,134,31435,82,1075,256,1265,174,190,728,33060,0.9157894736842104,257.63540129415446
643,1573,31435,96,1067,227,1236,131,169,600,22139,0.7751479289940828,213.82703290276467
644,1706,30913,50,694,268,921,218,227,890,49486,0.9603524229074889,314.7268657105713
645,391,30913,50,692,270,886,220,194,828,42680,1.134020618556701,293.318939040765
646,886,30913,57,695,259,921,202,226,856,45652,0.8938053097345132,303.1171390733292
647,1652,1306,19,446,256,596,237,150,774,35550,1.58,280.47994580718245
648,744,1306,32,437,271,601,239,164,806,39196,1.4573170731707317,289.85686122636463
649,338,1306,189,453,239,508,50,55,210,2750,0.9090909090909092,74.33034373659252
650,941,1306,30,430,278,598,248,168,832,41664,1.4761904761904765,299.5463236295849
651,240,1306,69,450,242,578,173,128,602,22144,1.3515625,215.20455385516357
652,852,1306,21,435,269,600,248,165,826,40920,1.5030303030303032,297.87413449307746
653,853,1306,131,436,278,574,147,138,570,20286,1.065217391304348,201.62589119455865
654,1479,8562,70,405,677,882,607,477,2168,289539,1.2725366876310271,771.9961139798568
655,178,8562,219,388,564,669,345,281,1252,96945,1.2277580071174377,444.95617761752675
656,1319,8562,52,426,667,834,615,408,2046,250920,1.5073529411764706,738.0304871751573
657,386,8562,126,502,592,708,466,206,1344,95996,2.2621359223300965,509.5017173670762
658,387,8562,63,410,650,788,587,378,1930,221886,1.5529100529100532,698.1783439780985
659,1585,26923,252,804,742,1274,490,470,1920,230300,1.0425531914893618,678.9698078707182
660,314,26923,165,768,698,1327,533,559,2184,297947,0.9534883720930232,772.3794404306733
661,831,26923,206,773,721,1286,515,513,2056,264195,1.003898635477583,726.9071467525958
662,153,26923,222,809,719,1256,497,447,1888,222159,1.1118568232662192,668.4444629137113
663,266,26923,80,748,800,1329,720,581,2602,418320,1.2392426850258176,925.181603794628
664,1508,28416,58,548,726,1069,668,521,2378,348028,1.2821497120921306,847.1511081265254
665,436,28416,31,537,751,1057,720,520,2480,374400,1.3846153846153846,888.1441324469807
666,422,28416,52,581,729,1044,677,463,2280,313451,1.4622030237580994,820.1816871888814
667,1017,707,49,815,68,837,19,22,82,418,0.8636363636363636,29.068883707497267
668,1383,707,44,814,69,834,25,20,90,500,1.25,32.01562118716424
669,1385,707,47,820,74,834,27,14,82,378,1.9285714285714288,30.4138126514911
670,1573,707,50,820,68,832,18,12,60,216,1.5,21.633307652783937
671,1508,707,44,820,70,831,26,11,74,286,2.363636363636364,28.231188426986208
672,1445,707,55,823,66,828,11,5,32,55,2.2,12.083045973594572
673,1123,25083,64,472,600,825,536,353,1778,189208,1.518413597733711,641.7982549056985
674,957,25083,91,465,589,847,498,382,1760,190236,1.3036649214659686,627.636837669683
675,687,25083,135,468,572,791,437,323,1520,141151,1.3529411764705883,543.4132865508535
676,952,25083,151,487,495,786,344,299,1286,102856,1.1505016722408026,455.78174601447125
677,1053,25083,115,496,575,815,460,319,1558,146740,1.4420062695924765,559.7865664697573
678,806,28809,142,813,648,1355,506,542,2096,274252,0.933579335793358,741.4849964766651
679,907,28809,68,841,661,1334,593,493,2172,292349,1.202839756592292,771.1666486564367
680,1141,28809,113,876,601,1345,488,469,1914,228872,1.0405117270788913,676.8345440356898
681,1158,19808,130,631,790,1381,660,750,2820,495000,0.88,999.0495483208027
682,1623,19808,772,724,781,733,9,9,36,81,1.0,12.727922061357855
683,377,19808,85,658,850,1485,765,827,3184,632655,0.9250302297460702,1126.5673526247776
684,711,19808,328,798,564,1173,236,375,1222,88500,0.6293333333333333,443.08125665615785
685,309,19808,44,611,818,1458,774,847,3242,655578,0.9138134592680048,1147.3818021914065
686,1212,19808,70,627,790,1381,720,754,2948,542880,0.9549071618037136,1042.5526365608596
687,496,19808,122,623,822,1434,700,811,3022,567700,0.8631319358816276,1071.3174132814233
688,1084,32812,93,1392,115,1414,22,22,88,484,1.0,31.11269837220809
689,1035,32812,62,1394,124,1426,62,32,188,1984,1.9375,69.77105417004964
690,1578,32812,54,1388,119,1426,65,38,206,2470,1.7105263157894737,75.29276193632427
691,1304,32812,55,1384,119,1429,64,45,218,2880,1.4222222222222225,78.2368199762746
692,46,32812,55,1384,116,1438,61,54,230,3294,1.1296296296296295,81.46778504415104
693,874,32812,57,1384,116,1427,59,43,204,2537,1.372093023255814,73.00684899377592
694,1520,32812,93,1401,104,1436,11,35,92,385,0.3142857142857143,36.68787265568828
695,1249,32812,54,1383,116,1425,62,42,208,2604,1.4761904761904765,74.88658090739622
696,952,5489,280,316,404,502,124,186,620,23064,0.6666666666666666,223.54417907876734
697,1540,5489,199,262,623,664,424,402,1652,170448,1.054726368159204,584.27733141035
698,681,5489,111,243,198,379,87,136,446,11832,0.6397058823529411,161.4465855941215
699,1494,5489,214,277,617,650,403,373,1552,150319,1.0804289544235923,549.1247581378934
700,1128,5489,239,258,522,648,283,390,1346,110370,0.7256410256410256,481.859938156307
701,632,5489,20,228,708,669,688,441,2258,303408,1.5600907029478461,817.2056044839634
702,577,5489,113,253,567,658,454,405,1718,183870,1.1209876543209876,608.3921432760288
703,572,5489,198,272,521,544,323,272,1190,87856,1.1875,422.2712398447235
704,509,33873,158,845,719,1262,561,417,1956,233937,1.3453237410071943,699.0064377385947
705,1222,33873,289,823,664,1291,375,468,1686,175500,0.8012820512820513,599.7074286683466
706,1271,33873,109,824,792,1382,683,558,2482,381114,1.224014336917563,881.9597496484746
707,1281,3419,284,864,533,1145,249,281,1060,69969,0.8861209964412812,375.44906445482053
708,335,3419,261,887,564,1107,303,220,1046,66660,1.3772727272727272,374.44492251865296
709,242,3419,196,853,609,1236,413,383,1592,158179,1.0783289817232375,563.2566022693387
710,464,3419,376,940,481,1040,105,100,410,10500,1.05,145.0
711,889,3419,96,804,754,1273,658,469,2254,308602,1.4029850746268655,808.0377466430637
712,577,3419,244,855,563,1180,319,325,1288,103675,0.9815384615384616,455.3965305094012
713,389,17578,51,734,188,777,137,43,360,5891,3.1860465116279064,143.58969322343438
714,1217,17578,107,732,211,799,104,67,342,6968,1.5522388059701493,123.71337841963576
715,1701,17578,43,741,209,767,166,26,384,4316,6.384615384615384,168.02380783686579
716,512,17578,47,703,211,790,164,87,502,14268,1.885057471264368,185.64751546950473
717,560,17578,62,733,154,781,92,48,280,4416,1.9166666666666667,103.76897416858277
718,167,17578,58,729,205,793,147,64,422,9408,2.296875,160.3277892319357
719,674,17578,41,733,210,773,169,40,418,6760,4.225,173.66922582887275
720,1148,19548,260,921,543,1057,283,136,838,38488,2.0808823529411766,313.9824835878588
721,1558,19548,61,808,554,1152,493,344,1674,169592,1.4331395348837208,601.1530587130036
722,1663,19548,44,974,141,1150,97,176,546,17072,0.5511363636363636,200.9601950635996
723,295,19548,55,830,537,1144,482,314,1592,151348,1.535031847133758,575.2564645442935
724,763,19548,37,1001,121,1131,84,130,428,10920,0.6461538461538462,154.77725931156684
725,856,19548,47,1002,215,1120,168,118,572,19824,1.4237288135593218,205.2997808084558
726,296,19548,35,989,125,1120,90,131,442,11790,0.6870229007633588,158.93709447451215
727,1290,19548,257,799,568,1121,311,322,1266,100142,0.9658385093167702,447.66617026529934
728,1504,19548,479,941,531,1000,52,59,222,3068,0.8813559322033898,78.64477096412705
729,1187,28275,34,444,836,966,802,522,2648,418644,1.5363984674329505,956.9158792704822
730,1719,28275,47,449,870,936,823,487,2620,400801,1.6899383983572895,956.2938878817537
731,638,28275,39,455,834,1022,795,567,2724,450765,1.402116402116402,976.4804145501332
732,1200,22865,462,408,678,614,216,206,844,44496,1.0485436893203883,298.4828303269721
733,488,22865,324,233,868,732,544,499,2086,271456,1.0901803607214429,738.1984827944311
734,1350,22865,6,97,894,769,888,672,3120,596736,1.3214285714285714,1113.6103447795374
735,134,22865,385,120,873,655,488,535,2046,261080,0.9121495327102804,724.1332750260825
736,901,22865,170,134,882,732,712,598,2620,425776,1.1906354515050168,929.810733429121
737,298,22865,432,290,793,657,361,367,1456,132487,0.983651226158038,514.7912198163446
738,247,22865,382,324,808,648,426,324,1500,138024,1.3148148148148149,535.2121074863684
739,1241,22865,437,222,764,678,327,456,1566,149112,0.7171052631578947,561.1283275686587
740,1562,22865,416,205,830,675,414,470,1768,194580,0.8808510638297873,626.3353734222585
741,140,27029,202,592,785,1037,583,445,2056,259435,1.3101123595505615,733.4262062402734
742,146,27029,367,608,683,845,316,237,1106,74892,1.3333333333333333,395.0
743,651,27029,426,653,703,839,277,186,926,51522,1.4892473118279568,333.65401241405743
744,38,27029,249,632,658,975,409,343,1504,140287,1.1924198250728864,533.7883475685845
745,1573,27029,246,634,643,958,397,324,1442,128628,1.2253086419753083,512.4304830901456
746,45,27029,161,638,698,972,537,334,1742,179358,1.6077844311377243,632.3962365479415
747,305,27029,278,650,612,1028,334,378,1424,126252,0.8835978835978836,504.42045953747754
748,1386,27029,104,555,693,1047,589,492,2162,289788,1.1971544715447155,767.4535816582004
749,1498,27029,205,653,676,928,471,275,1492,129525,1.7127272727272729,545.4044370923287
750,746,15596,251,969,368,1139,117,170,574,19890,0.6882352941176471,206.37102509800158
751,410,15596,104,892,502,1193,398,301,1398,119798,1.3222591362126246,499.0040079999358
752,413,15596,122,919,469,1199,347,280,1254,97160,1.2392857142857143,445.88002870727456
753,1435,15596,159,904,471,1202,312,298,1220,92976,1.046979865771812,431.4487223297805
754,313,5380,22,595,29,599,7,4,22,28,1.75,8.06225774829855
755,1357,5380,22,595,28,599,6,4,20,24,1.5,7.211102550927978
756,546,5380,22,595,29,599,7,4,22,28,1.75,8.06225774829855
757,873,5380,22,595,25,599,3,4,14,12,0.75,5.0
758,1745,5380,22,597,27,599,5,2,14,10,2.5,5.385164807134504
759,1097,5380,22,595,29,600,7,5,24,35,1.4,8.602325267042627
760,1683,5380,23,595,28,599,5,4,18,20,1.25,6.4031242374328485
761,1396,5380,23,595,28,600,5,5,20,25,1.0,7.0710678118654755
762,827,5380,23,597,26,599,3,2,10,6,1.5,3.605551275463989
763,1087,5380,22,595,28,599,6,4,20,24,1.5,7.211102550927978
764,917,13515,280,289,740,1022,460,733,2386,337180,0.6275579809004093,865.3837299140769
765,497,13515,40,341,779,1048,739,707,2892,522473,1.0452616690240453,1022.7267474746126
766,1212,13515,222,304,890,860,668,556,2448,371408,1.2014388489208634,869.1144918823986
767,1420,5970,22,365,283,555,261,190,902,49590,1.3736842105263158,322.8327740487325
768,69,5970,137,383,266,524,129,141,540,18189,0.9148936170212766,191.10729970359583
769,947,5970,33,366,34,367,1,1,4,1,1.0,1.4142135623730951
770,852,29169,43,792,591,1151,548,359,1814,196732,1.5264623955431755,655.1221260192636
771,952,29169,54,789,578,1147,524,358,1764,187592,1.4636871508379887,634.6179953326252
772,1183,29169,40,775,595,1112,555,337,1784,187035,1.6468842729970326,649.3027029052013
773,999,29169,31,773,608,1153,577,380,1914,219260,1.5184210526315791,690.8900057172632
774,10,29169,62,794,581,1120,519,326,1690,169194,1.5920245398773003,612.8923233325736
775,592,21540,186,802,726,1434,540,632,2344,341280,0.8544303797468354,831.2785333448711
776,865,21540,148,770,783,1390,635,620,2510,393700,1.0241935483870968,887.4823941915693
777,805,21540,226,764,825,1328,599,564,2326,337836,1.0620567375886525,822.7375037033379
778,447,15418,56,695,373,1043,317,348,1330,110316,0.9109195402298852,470.73665674132496
779,1684,15418,404,684,620,1014,216,330,1092,71280,0.6545454545454545,394.4058823090751
780,1587,15418,63,706,415,1033,352,327,1358,115104,1.0764525993883791,480.4508299503707
781,552,15418,51,702,360,1052,309,350,1318,108150,0.8828571428571429,466.8843539892936
782,1681,15418,40,689,692,1049,652,360,2024,234720,1.8111111111111111,744.7845325998654
783,1581,15418,118,708,556,1043,438,335,1546,146730,1.307462686567164,551.4245188600158
784,948,3864,118,305,679,646,561,341,1804,191301,1.6451612903225807,656.5074257005781
785,852,3864,106,293,691,712,585,419,2008,245115,1.3961813842482098,719.573484781089
786,1006,3864,94,296,638,546,544,250,1588,136000,2.176,598.6952480185557
787,969,5225,32,670,191,810,159,140,598,22260,1.1357142857142857,211.85136298829894
788,1393,5225,35,522,678,867,643,345,1976,221835,1.863768115942029,729.7081608424014
789,1508,5225,35,773,291,878,256,105,722,26880,2.4380952380952383,276.6965847277483
790,1064,5225,20,523,310,939,290,416,1412,120640,0.6971153846153846,507.1055117034324
791,696,5225,595,531,601,535,6,4,20,24,1.5,7.211102550927978
792,423,5225,44,594,297,931,253,337,1180,85261,0.7507418397626113,421.40004746084213
793,1389,5225,22,517,314,905,292,388,1360,113296,0.7525773195876289,485.60065897813604
794,819,5225,34,536,692,920,658,384,2084,252672,1.7135416666666667,761.8530041943787
795,1021,5225,397,624,679,903,282,279,1122,78678,1.010752688172043,396.69257618463195
796,917,10339,239,178,563,456,324,278,1204,90072,1.1654676258992809,426.91919610155736
797,1212,10339,173,172,573,571,400,399,1598,159600,1.0025062656641603,564.978760662735
798,821,10339,122,415,620,636,498,221,1438,110058,2.253393665158371,544.8348373589927
799,952,399,159,831,289,953,130,122,504,15860,1.0655737704918034,178.2806775845324
800,576,399,90,794,377,1038,287,244,1062,70028,1.1762295081967211,376.70280062670093
801,1650,399,272,850,316,901,44,51,190,2244,0.8627450980392157,67.35725647619564
802,521,399,107,798,345,1022,238,224,924,53312,1.0625,326.83329083800504
803,1274,399,110,794,348,1047,238,253,982,60214,0.9407114624505928,347.3514070793438
804,744,399,79,746,364,1154,285,408,1386,116280,0.6985294117647058,497.68363445064176
805,1094,17861,368,529,777,1082,409,553,1924,226177,0.7396021699819169,687.8153822065918
806,1522,17861,281,535,865,1105,584,570,2308,332880,1.024561403508772,816.061272209385
807,1684,17861,354,544,770,1078,416,534,1900,222144,0.7790262172284644,676.9135838495191
808,1304,34085,303,637,530,965,227,328,1110,74456,0.6920731707317073,398.8897090675567
809,1578,34085,282,658,547,1000,265,342,1214,90630,0.7748538011695907,432.6534409894367
810,1084,34085,311,632,505,1008,194,376,1140,72944,0.5159574468085106,423.0980973722288
811,831,11147,271,450,909,1020,638,570,2416,363660,1.119298245614035,855.5372581015978
812,1212,11147,188,468,974,1010,786,542,2656,426012,1.4501845018450183,954.7565134629876
813,917,11147,177,543,941,895,764,352,2232,268928,2.1704545454545454,841.1896337925236
814,1712,35682,54,1482,68,1491,14,9,46,126,1.5555555555555556,16.64331697709324
815,745,35682,54,1482,62,1488,8,6,28,48,1.3333333333333333,10.0
816,1234,35682,54,1482,67,1491,13,9,44,117,1.4444444444444444,15.811388300841896
817,193,35682,54,1483,58,1491,4,8,24,32,0.5,8.94427190999916
818,891,35682,54,1477,73,1492,19,15,68,285,1.2666666666666666,24.20743687382041
819,952,35682,54,1483,69,1491,15,8,46,120,1.875,17.0
820,849,35682,57,1482,70,1491,13,9,44,117,1.4444444444444444,15.811388300841896
821,519,35682,55,1483,69,1491,14,8,44,112,1.75,16.1245154965971
822,1375,17239,45,613,424,974,379,361,1480,136819,1.049861495844875,523.4137942393188
823,1713,17239,28,607,431,1001,403,394,1594,158782,1.0228426395939083,563.6000354861593
824,1721,17239,33,635,424,947,391,312,1406,121992,1.2532051282051282,500.22494939776846
825,201,11275,100,380,355,656,255,276,1062,70380,0.9239130434782608,375.76721517450136
826,140,11275,57,348,402,628,345,280,1250,96600,1.2321428571428572,444.3253312607779
827,1239,11275,30,321,103,543,73,222,590,16206,0.3288288288288289,233.69424468736923
828,1681,15455,200,725,1025,1319,825,594,2838,490050,1.3888888888888888,1016.592838849458
829,56,15455,174,729,942,1344,768,615,2766,472320,1.2487804878048778,983.8948114508989
830,1684,15455,259,796,967,1335,708,539,2494,381612,1.313543599257885,889.8230161105072
831,1361,8182,223,742,570,1133,347,391,1476,135677,0.8874680306905369,522.7714605829206
832,213,8182,184,719,550,1085,366,366,1464,133956,1.0,517.6021638285528
833,154,8182,181,761,498,1103,317,342,1318,108414,0.9269005847953216,466.31856064282925
834,1084,8182,247,720,448,1092,201,372,1146,74772,0.5403225806451613,422.8297529739363
835,375,8182,129,760,506,1053,377,293,1340,110461,1.286689419795222,477.47041793183377
836,1685,8182,155,768,550,1127,395,359,1508,141805,1.1002785515320337,533.7658662747178
837,265,8182,200,712,573,1105,373,393,1532,146589,0.9491094147582696,541.8283861150134
838,480,18410,56,683,224,821,168,138,612,23184,1.2173913043478262,217.41205118392128
839,246,18410,27,675,239,841,212,166,756,35192,1.2771084337349397,269.2582403567252
840,254,18410,42,682,224,835,182,153,670,27846,1.1895424836601307,237.7666923688009
841,873,4294,96,511,959,1185,863,674,3074,581662,1.2804154302670625,1095.009132382009
842,100,4294,75,491,993,1165,918,674,3184,618732,1.3620178041543027,1138.859078200635
843,1396,4294,93,531,931,1030,838,499,2674,418162,1.6793587174348696,975.3178968931104
844,909,12559,52,692,129,799,77,107,368,8239,0.7196261682242991,131.8256424221024
845,1665,12559,79,693,119,762,40,69,218,2760,0.5797101449275363,79.75587752636166
846,1135,12559,41,680,119,794,78,114,384,8892,0.6842105263157895,138.13037319865606
847,199,12559,62,699,118,774,56,75,262,4200,0.7466666666666667,93.60021367496978
848,968,12559,45,700,122,790,77,90,334,6930,0.8555555555555555,118.44407963254221
849,437,12559,72,693,111,733,39,40,158,1560,0.975,55.86591089385369
850,963,12559,61,700,117,770,56,70,252,3920,0.8,89.64373932405988
851,1497,12559,53,693,122,803,69,110,358,7590,0.6272727272727273,129.84991336154215
852,1663,12559,50,689,129,795,79,106,370,8374,0.7452830188679245,132.20060514233663
853,803,24505,89,779,704,1253,615,474,2178,291510,1.2974683544303798,776.4669986548043
854,952,24505,65,752,456,1317,391,565,1912,220915,0.6920353982300885,687.0997016445284
855,1541,24505,91,806,734,1058,643,252,1790,162036,2.5515873015873014,690.6178393293935
856,22,24505,82,746,714,1285,632,539,2342,340648,1.1725417439703154,830.6292795224595
857,242,24505,69,716,730,1335,661,619,2560,409159,1.0678513731825523,905.5837896075658
858,634,24505,748,1060,759,1179,11,119,260,1309,0.09243697478991596,119.50732195141852
859,957,24505,91,733,402,1270,311,537,1696,167007,0.5791433891992551,620.556202128381
860,134,31294,73,898,263,1064,190,166,712,31540,1.144578313253012,252.30140705116966
861,1139,31294,63,892,251,1051,188,159,694,29892,1.1823899371069182,246.22144504490262
862,1508,31294,63,896,262,1093,199,197,792,39203,1.0101522842639594,280.01785657346926
863,653,22378,149,755,418,1177,269,422,1382,113518,0.6374407582938388,500.4448021510464
864,1562,22378,202,785,371,992,169,207,752,34983,0.8164251207729468,267.22649569232465
865,91,22378,209,747,888,1239,679,492,2342,334068,1.3800813008130082,838.513565781735
866,1200,22378,233,838,367,1027,134,189,646,25326,0.7089947089947091,231.68297304722245
867,298,22378,411,875,636,1135,225,260,970,58500,0.8653846153846154,343.8386249390839
868,422,22378,156,686,903,1211,747,525,2544,392175,1.4228571428571428,913.0355962392704
869,89,22378,168,768,821,1165,653,397,2100,259241,1.6448362720403022,764.210703929224
870,809,22378,85,715,904,1238,819,523,2684,428337,1.5659655831739965,971.7458515476153
871,805,22378,144,718,412,1197,268,479,1494,128372,0.5594989561586639,548.8761244579691
872,1045,2288,43,522,115,576,72,54,252,3888,1.3333333333333333,90.0
873,1363,2288,33,511,125,584,92,73,330,6716,1.2602739726027397,117.44360348695028
874,1219,2288,38,506,118,571,80,65,290,5200,1.2307692307692308,103.07764064044152
875,922,30745,34,490,295,641,261,151,824,39411,1.7284768211920531,301.53275112332324
876,1706,30745,38,480,326,687,288,207,990,59616,1.391304347826087,354.67308891428456
877,886,30745,23,482,322,664,299,182,962,54418,1.6428571428571428,350.03571246374275
878,1046,30745,48,516,146,628,98,112,420,10976,0.875,148.8220413782851
879,1411,30745,29,480,329,678,300,198,996,59400,1.5151515151515151,359.4495792180038
880,998,30745,25,496,327,657,302,161,926,48622,1.8757763975155282,342.23529917295207
881,1610,18662,62,514,302,660,240,146,772,35040,1.643835616438356,280.9199174141983
882,891,18662,26,503,316,665,290,162,904,46980,1.7901234567901234,332.1806737304264
883,78,18662,49,507,288,660,239,153,784,36567,1.562091503267974,283.7780823108085
884,1398,27602,117,454,373,585,256,131,774,33536,1.954198473282443,287.5708608325955
885,1302,27602,70,387,398,648,328,261,1178,85608,1.2567049808429118,419.1718024867608
886,831,27602,75,417,456,629,381,212,1186,80772,1.7971698113207548,436.0103209787585
887,538,27602,51,389,470,700,419,311,1460,130309,1.347266881028939,521.8064775374104
888,1078,27602,31,378,509,693,478,315,1586,150570,1.5174603174603174,572.458732137086
889,1305,27602,46,374,498,695,452,321,1546,145092,1.4080996884735202,554.3870489107768
890,768,27602,50,376,499,686,449,310,1518,139190,1.4483870967741936,545.6198310178984
891,1507,17640,144,759,252,1027,108,268,752,28944,0.4029850746268657,288.9429009337312
892,1068,17640,148,740,297,1017,149,277,852,41273,0.5379061371841155,314.5313974788527
893,489,17640,221,865,247,916,26,51,154,1326,0.5098039215686274,57.245087125446844
894,1022,17640,107,767,338,1032,231,265,992,61215,0.8716981132075472,351.5480052567501
895,531,17640,129,732,302,1036,173,304,954,52592,0.569078947368421,349.7785013404912
896,648,17640,118,737,318,1018,200,281,962,56200,0.7117437722419929,344.90723390500233
897,643,17640,140,743,346,1041,206,298,1008,61388,0.6912751677852349,362.27061708065696
898,71,29774,48,498,103,547,55,49,208,2695,1.1224489795918366,73.66138744281159
899,943,29774,44,505,99,538,55,33,176,1815,1.6666666666666667,64.1404708432983
900,941,29774,44,507,106,541,62,34,192,2108,1.8235294117647056,70.71067811865476
901,239,29774,40,490,107,554,67,64,262,4288,1.046875,92.65527507918802
902,411,29774,41,495,89,535,48,40,176,1920,1.2,62.48199740725323
903,290,29774,45,500,100,538,55,38,186,2090,1.4473684210526316,66.85057965343307
904,1183,29774,32,481,119,571,87,90,354,7830,0.9666666666666668,125.1758762701504
905,744,29774,48,505,96,531,48,26,148,1248,1.8461538461538465,54.589376255824725
906,852,29774,46,501,96,536,50,35,170,1750,1.4285714285714286,61.032778078668514
907,686,29774,44,500,101,547,57,47,208,2679,1.2127659574468086,73.87827826905551
908,577,29774,49,507,92,531,43,24,134,1032,1.7916666666666667,49.24428900898052
909,818,27347,44,659,74,682,30,23,106,690,1.3043478260869563,37.8021163428716
910,1442,27347,43,659,78,681,35,22,114,770,1.5909090909090908,41.340053217188775
911,1206,27347,57,660,73,670,16,10,52,160,1.6,18.867962264113206
912,157,28128,61,982,764,1509,703,527,2460,370481,1.3339658444022773,878.6000227634871
913,917,28128,106,998,747,1540,641,542,2366,347422,1.1826568265682658,839.4313551446598
914,214,28128,78,1021,727,1559,649,538,2374,349162,1.2063197026022303,842.9976275174207
915,153,28128,104,1006,695,1495,591,489,2160,288999,1.2085889570552146,767.0736600874782
916,266,28128,58,999,753,1584,695,585,2560,406575,1.188034188034188,908.4327162756745
917,1319,8578,56,923,118,978,62,55,234,3410,1.1272727272727272,82.87943049997388
918,1698,8578,66,920,115,971,49,51,200,2499,0.9607843137254902,70.7248188403477
919,178,8578,53,918,126,976,73,58,262,4234,1.2586206896551724,93.23625904121208
920,1479,8578,57,920,126,976,69,56,250,3864,1.2321428571428572,88.86506625215557
921,958,1323,133,391,562,783,429,392,1642,168168,1.094387755102041,581.1239110551209
922,1652,1323,62,352,694,781,632,429,2122,271128,1.4731934731934733,763.8488070292445
923,852,1323,62,355,690,779,628,424,2104,266272,1.481132075471698,757.7334623731488
924,1655,1323,150,379,565,781,415,402,1634,166830,1.0323383084577114,577.7793696559268
925,338,1323,156,417,379,636,223,219,884,48837,1.0182648401826484,312.553995335206
926,343,1323,93,353,648,777,555,424,1958,235320,1.3089622641509433,698.4275195036347
927,166,7693,97,592,829,1217,732,625,2714,457500,1.1712,962.5222075360132
928,875,7693,171,661,593,1028,422,367,1578,154874,1.1498637602179838,559.2611196927603
929,161,7693,130,619,885,1252,755,633,2776,477915,1.1927330173775672,985.2481920815688
930,158,7693,171,646,621,1069,450,423,1746,190350,1.0638297872340423,617.5993847147195
931,712,7693,176,715,841,1184,665,469,2268,311885,1.417910447761194,813.7481182773943
932,1628,7693,171,666,887,1161,716,495,2422,354420,1.4464646464646465,870.4487348488709
933,1361,7693,148,579,709,1099,561,520,2162,291720,1.0788461538461538,764.9320231236237
934,266,7693,92,637,880,1245,788,608,2792,479104,1.2960526315789471,995.2929217069717
935,1149,7693,148,607,681,1066,533,459,1984,244647,1.1612200435729847,703.3988910994956
936,824,18593,111,641,248,760,137,119,512,16303,1.1512605042016806,181.46625030566977
937,606,18593,115,671,203,763,88,92,360,8096,0.9565217391304348,127.31064370271639
938,774,18593,42,646,259,803,217,157,748,34069,1.382165605095541,267.83950418114205
939,1033,18593,40,644,255,797,215,153,736,32895,1.4052287581699343,263.8825496314601
940,317,18593,241,651,242,652,1,1,4,1,1.0,1.4142135623730951
941,1383,13457,94,950,359,1303,265,353,1236,93545,0.7507082152974505,441.40004531037374
942,306,13457,109,969,297,1143,188,174,724,32712,1.0804597701149423,256.1640099623677
943,650,13457,58,972,418,1298,360,326,1372,117360,1.1042944785276074,485.67067031065403
944,909,13457,105,968,252,1230,147,262,818,38514,0.5610687022900763,300.42137074449283
945,1389,13457,54,977,346,1300,292,323,1230,94316,0.9040247678018576,435.42278305113985
946,666,24672,44,598,650,1164,606,566,2344,342996,1.0706713780918728,829.2116738203822
947,706,24672,100,668,623,1067,523,399,1844,208677,1.3107769423558897,657.8221644183176
948,1152,24672,37,609,608,1179,571,570,2282,325470,1.0017543859649125,806.8091471965349
949,1090,24672,31,594,648,1198,617,604,2442,372668,1.021523178807947,863.42631416931
950,1030,24672,67,586,658,1188,591,602,2386,355782,0.9817275747508306,843.6142483386586
951,375,24672,34,583,673,1202,639,619,2516,395541,1.032310177705977,889.6527412423344
952,657,24672,61,615,669,1196,608,581,2378,353248,1.0464716006884682,840.9667056429761
953,982,24672,35,592,663,1192,628,600,2456,376800,1.0466666666666666,868.5528193495201
954,1344,16449,113,768,401,982,288,214,1004,61632,1.3457943925233644,358.8035674293108
955,1730,16449,127,773,336,965,209,192,802,40128,1.0885416666666667,283.8045101826255
956,902,16449,70,768,392,968,322,200,1044,64400,1.61,379.05672398732094
957,909,16449,84,772,366,978,282,206,976,58092,1.3689320388349515,349.22771940382967
958,651,16449,110,823,375,955,265,132,794,34980,2.0075757575757582,296.05573799539843
959,755,16449,44,759,406,956,362,197,1118,71314,1.8375634517766497,412.13226032427986
960,360,16449,60,777,387,949,327,172,998,56244,1.9011627906976745,369.47665690811914
961,36,16449,89,761,401,960,312,199,1022,62088,1.5678391959798994,370.06080581439585
962,644,16449,43,759,406,957,363,198,1122,71874,1.8333333333333333,413.488814842675
963,1557,16449,53,766,406,962,353,196,1098,69188,1.8010204081632653,403.7635446644484
964,1336,4462,129,1096,320,1357,191,261,904,49851,0.7318007662835249,323.4223245232153
965,1229,4462,81,1092,361,1375,280,283,1126,79240,0.9893992932862192,398.1067695983076
966,477,4462,109,1112,315,1346,206,234,880,48204,0.8803418803418803,311.75631509241316
967,218,12249,81,648,797,1253,716,605,2642,433180,1.1834710743801653,937.379858968604
968,177,12249,166,673,536,941,370,268,1276,99160,1.3805970149253732,456.86321804233705
969,1172,12249,134,687,567,878,433,191,1248,82703,2.2670157068062826,473.2546883021868
970,1469,12249,99,667,536,892,437,225,1324,98325,1.9422222222222223,491.5221256464453
971,1599,12249,213,1012,734,1230,521,218,1478,113578,2.389908256880734,564.769864635145
972,621,12249,94,690,527,927,433,237,1340,102621,1.8270042194092824,493.6172606382398
973,1219,12249,87,710,707,1255,620,545,2330,337900,1.1376146788990826,825.4847060969694
974,66,12249,115,677,737,1229,622,552,2348,343344,1.1268115942028984,831.6177006293216
975,993,12249,436,1024,711,1204,275,180,910,49500,1.5277777777777777,328.6715685908959
976,886,5856,342,311,779,804,437,493,1860,215441,0.8864097363083164,658.800425015042
977,559,5856,270,332,838,741,568,409,1954,232312,1.3887530562347188,699.9321395678298
978,389,5856,375,374,772,795,397,421,1636,167137,0.9429928741092636,578.6622503671723
979,739,14310,99,971,417,1222,318,251,1138,79818,1.2669322709163346,405.123437979093
980,802,14310,142,947,443,1173,301,226,1054,68026,1.331858407079646,376.4000531349591
981,1233,14310,103,964,441,1204,338,240,1156,81120,1.4083333333333334,414.5407097017131
982,896,14310,48,952,413,1188,365,236,1202,86140,1.5466101694915255,434.6504342572316
983,133,14310,45,974,425,1224,380,250,1260,95000,1.52,454.86261662176634
984,17,14310,220,1021,427,1150,207,129,672,26703,1.6046511627906976,243.90571949013415
985,1007,14310,60,940,433,1213,373,273,1292,101829,1.3663003663003663,462.23154370942706
986,21,33605,325,572,656,903,331,331,1324,109561,1.0,468.10468914549443
987,957,33605,292,541,691,906,399,365,1528,145635,1.0931506849315071,540.7642739678722
988,952,33605,353,577,605,885,252,308,1120,77616,0.8181818181818182,397.95477129945306
989,777,1508,183,825,185,827,2,2,8,4,1.0,2.8284271247461903
990,1749,1508,91,827,422,1130,331,303,1268,100293,1.0924092409240924,448.7426879627121
991,382,1508,88,823,388,1132,300,309,1218,92700,0.9708737864077671,430.6750515179629
992,379,1508,131,831,379,1128,248,297,1090,73656,0.835016835016835,386.927641814332
993,1690,1508,88,827,422,1128,334,301,1270,100534,1.1096345514950166,449.61872736797784
994,831,1508,83,825,401,1121,318,296,1228,94128,1.0743243243243243,434.44217106537894
995,663,1582,24,419,245,556,221,137,716,30277,1.6131386861313868,260.0192300580863
996,379,1582,26,432,227,558,201,126,654,25326,1.5952380952380951,237.22773868163057
997,831,1582,139,418,243,482,104,64,336,6656,1.625,122.11470017978998
998,777,1582,62,500,207,542,145,42,374,6090,3.452380952380953,150.9602596712128
999,1029,1582,118,420,241,563,123,143,532,17589,0.8601398601398601,188.62131374794313
1000,1624,1582,154,417,244,507,90,90,360,8100,1.0,127.27922061357856
1001,214,1582,34,431,189,508,155,77,464,11935,2.012987012987013,173.07223925286226
1002,1356,1582,28,424,235,557,207,133,680,27531,1.5563909774436093,246.04471138392714
1003,1020,156,87,812,150,875,63,63,252,3969,1.0,89.09545442950498
1004,533,156,92,802,155,887,63,85,296,5355,0.7411764705882353,105.80170130957252
1005,422,156,74,802,160,879,86,77,326,6622,1.1168831168831168,115.43396380615195
1006,161,8199,79,380,297,557,218,177,790,38586,1.231638418079096,280.8077634254438
1007,866,8199,96,407,189,551,93,144,474,13392,0.6458333333333334,171.42053552593984
1008,1084,8199,97,387,263,549,166,162,656,26892,1.0246913580246917,231.94827009486403
1009,1361,8199,75,414,244,573,169,159,656,26871,1.0628930817610065,232.038789860661
1010,446,8199,103,379,288,546,185,167,704,30895,1.1077844311377243,249.22680433693324
1011,265,8199,73,376,300,565,227,189,832,42903,1.2010582010582012,295.3811097548386
1012,1175,2440,249,532,534,895,285,363,1296,103455,0.7851239669421488,461.5127300519456
1013,892,2440,320,599,444,835,124,236,720,29264,0.5254237288135594,266.5933232472261
1014,950,2440,261,540,553,813,292,273,1130,79716,1.0695970695970696,399.74116625636645
1015,577,2440,248,546,534,903,286,357,1286,102102,0.8011204481792717,457.43305521136097
1016,575,2440,152,573,553,798,401,225,1252,90225,1.7822222222222222,459.8108306684391
1017,1334,2440,232,540,584,901,352,361,1426,127072,0.9750692520775625,504.2072986381693
1018,1182,22572,83,1020,191,1147,108,127,470,13716,0.8503937007874016,166.71232707871366
1019,1188,22572,61,1002,192,1159,131,157,576,20567,0.8343949044585988,204.47493733951845
1020,330,22572,51,999,198,1159,147,160,614,23520,0.91875,217.27632176562636
1021,1577,16038,94,513,388,809,294,296,1180,87024,0.9932432432432432,417.1953978653168
1022,552,16038,126,511,424,806,298,295,1186,87910,1.0101694915254238,419.31968711235106
1023,548,16038,171,521,419,756,248,235,966,58280,1.0553191489361702,341.65626000411584
1024,1562,2075,143,209,592,663,449,454,1806,203846,0.9889867841409692,638.5272116362779
1025,704,2075,12,244,574,749,562,505,2134,283810,1.1128712871287127,755.5587336534467
1026,1384,2075,14,196,883,721,869,525,2788,456225,1.6552380952380952,1015.2763170684127
1027,1383,2075,7,288,607,700,600,412,2024,247200,1.4563106796116505,727.8351461697903
1028,582,2075,59,179,852,693,793,514,2614,407602,1.5428015564202335,945.0105819513345
1029,761,2075,391,239,828,506,437,267,1408,116679,1.6367041198501873,512.1113160241629
1030,1418,14564,29,623,258,785,229,162,782,37098,1.4135802469135803,280.5084668953862
1031,1174,14564,64,635,254,781,190,146,672,27740,1.3013698630136987,239.61636004246455
1032,785,14564,89,638,269,774,180,136,632,24480,1.3235294117647058,225.6014184352572
1033,510,14564,48,620,264,755,216,135,702,29160,1.6,254.7174905655283
1034,387,14564,47,618,253,784,206,166,744,34196,1.2409638554216869,264.5600120955546
1035,1022,18101,199,803,675,1210,476,407,1766,193732,1.1695331695331694,626.2786919575022
1036,531,18101,104,730,656,1316,552,586,2276,323472,0.9419795221843004,805.0465825031494
1037,909,18101,245,779,695,1297,450,518,1936,233100,0.8687258687258688,686.1661606345798
1038,917,10712,53,388,712,1108,659,720,2758,474480,0.9152777777777776,976.0537895013779
1039,660,10712,36,458,735,1090,699,632,2662,441768,1.106012658227848,942.3507839440682
1040,831,10712,18,435,746,979,728,544,2544,396032,1.338235294117647,908.8014084496128
1041,1363,2226,48,973,392,1226,344,253,1194,87032,1.359683794466403,427.0187349519925
1042,565,2226,109,987,360,1242,251,255,1012,64005,0.9843137254901959,357.8072106595953
1043,1325,2226,107,941,314,1189,207,248,910,51336,0.8346774193548387,323.0371495664237
1044,718,247,69,640,125,702,56,62,236,3472,0.9032258064516128,83.54639429682169
1045,1400,247,59,631,152,703,93,72,330,6696,1.2916666666666667,117.61377470347595
1046,1243,247,50,624,165,743,115,119,468,13685,0.9663865546218487,165.48715962273326
1047,1351,247,61,631,160,747,99,116,430,11484,0.8534482758620692,152.50245899656832
1048,714,247,60,638,137,734,77,96,346,7392,0.8020833333333334,123.06502346320826
1049,1692,247,46,623,181,748,135,125,520,16875,1.08,183.98369492974098
1050,831,247,61,627,151,680,90,53,286,4770,1.69811320754717,104.44615837837216
1051,1586,247,52,630,162,743,110,113,446,12430,0.9734513274336284,157.69908052997647
1052,1006,21454,293,289,980,747,687,458,2290,314646,1.5,825.6712420812536
1053,1182,21454,235,592,670,963,435,371,1612,161385,1.1725067385444743,571.7219603968349
1054,1058,21454,177,335,987,1004,810,669,2958,541890,1.210762331838565,1050.5527116713374
1055,853,21454,181,527,660,990,479,463,1884,221777,1.0345572354211665,666.1906633990002
1056,522,21454,173,335,989,1004,816,669,2970,545904,1.2197309417040358,1055.185765635606
1057,330,21454,167,302,847,996,680,694,2748,471920,0.9798270893371758,971.6151501494818
1058,851,21454,193,392,833,982,640,590,2460,377600,1.0847457627118644,870.4596486914255
1059,120,21454,206,340,977,990,771,650,2842,501150,1.186153846153846,1008.4349260115895
1060,342,21454,208,526,644,1012,436,486,1844,211896,0.8971193415637858,652.9104073301329
1061,413,15569,39,1029,42,1034,3,5,16,15,0.6,5.830951894845301
1062,286,15569,38,1028,44,1034,6,6,24,36,1.0,8.48528137423857
1063,193,15569,38,1026,48,1035,10,9,38,90,1.1111111111111112,13.45362404707371
1064,746,15569,39,1029,43,1033,4,4,16,16,1.0,5.656854249492381
1065,1435,15569,37,1028,48,1034,11,6,34,66,1.8333333333333333,12.529964086141668
1066,410,15569,38,1028,48,1034,10,6,32,60,1.6666666666666667,11.661903789690601
1067,182,34000,78,893,113,939,35,46,162,1610,0.7608695652173914,57.8013840664737
1068,410,34000,78,894,105,926,27,32,118,864,0.84375,41.86884283091664
1069,1487,34000,78,894,105,924,27,30,114,810,0.9,40.36087214122113
1070,415,34000,84,899,106,919,22,20,84,440,1.1,29.732137494637012
1071,952,34000,86,899,100,920,14,21,70,294,0.6666666666666666,25.238858928247925
1072,1663,19192,159,299,440,567,281,268,1098,75308,1.0485074626865671,388.3104428160541
1073,1503,19192,226,344,436,557,210,213,846,44730,0.9859154929577464,299.11369075988483
1074,1339,19192,245,416,292,474,47,58,210,2726,0.8103448275862069,74.65252842335616
1075,295,19192,189,408,381,561,192,153,690,29376,1.2549019607843137,245.50560075077718
1076,756,19192,136,311,447,574,311,263,1148,81793,1.182509505703422,407.2959611879303
1077,763,19192,159,316,436,573,277,257,1068,71189,1.0778210116731517,377.85976234576765
1078,355,19192,95,317,418,556,323,239,1124,77197,1.3514644351464435,401.8084120572888
1079,1675,31420,41,711,511,1053,470,342,1624,160740,1.3742690058479532,581.2606988262668
1080,1196,31420,36,712,499,1058,463,346,1618,160198,1.3381502890173411,578.0008650512558
1081,1508,31420,27,719,269,1072,242,353,1190,85426,0.6855524079320113,427.98714933979034
1082,761,31420,237,784,471,983,234,199,866,46566,1.1758793969849246,307.17584540455
1083,1573,31420,32,713,309,1038,277,325,1204,90025,0.8523076923076923,427.029273001278
1084,32,31420,26,712,514,1066,488,354,1684,172752,1.3785310734463276,602.8764384183545
1085,544,22103,50,1134,442,1478,392,344,1472,134848,1.1395348837209305,521.5361924162119
1086,1158,22103,49,1195,449,1475,400,280,1360,112000,1.4285714285714286,488.2622246293481
1087,1088,22103,42,1196,412,1487,370,291,1322,107670,1.2714776632302405,470.7239105887866
1088,396,6516,36,750,211,880,175,130,610,22750,1.3461538461538465,218.0022935659164
1089,986,6516,40,756,194,878,154,122,552,18788,1.2622950819672132,196.468827043885
1090,395,6516,36,751,206,886,170,135,610,22950,1.2592592592592593,217.0829334609241
1091,1351,34655,178,1324,283,1437,105,113,436,11865,0.9292035398230089,154.25303886795876
1092,826,34655,52,1314,283,1466,231,152,766,35112,1.5197368421052633,276.52305509667724
1093,918,34655,196,1325,265,1396,69,71,280,4899,0.9718309859154929,99.00505037623081
1094,1581,34655,60,1331,104,1421,44,90,268,3960,0.4888888888888889,100.17983829094555
1095,1622,34655,194,1324,276,1409,82,85,334,6970,0.9647058823529412,118.10588469674151
1096,161,34655,204,1331,264,1392,60,61,242,3660,0.9836065573770492,85.56284240252891
1097,1585,34655,191,1324,262,1403,71,79,300,5609,0.8987341772151899,106.21675950620975
1098,663,34655,178,1316,276,1455,98,139,474,13622,0.7050359712230215,170.07351351694948
1099,193,35695,467,461,470,464,3,3,12,9,1.0,4.242640687119285
1100,849,35695,76,493,405,854,329,361,1380,118769,0.9113573407202216,488.42809092025
1101,952,35695,55,478,425,784,370,306,1352,113220,1.2091503267973855,480.1416457671632
1102,1658,35695,53,444,477,877,424,433,1714,183592,0.979214780600462,606.0239269203815
1103,1430,35695,83,477,425,806,342,329,1342,112518,1.03951367781155,474.55768880084537
1104,1522,17858,94,599,696,1079,602,480,2164,288960,1.2541666666666669,769.9376598140917
1105,1027,17858,467,565,734,834,267,269,1072,71823,0.9925650557620818,379.0118731649445
1106,1684,17858,135,634,571,1045,436,411,1694,179196,1.0608272506082723,599.1802733735483
1107,1395,17858,371,852,505,952,134,100,468,13400,1.34,167.20047846821492
1108,161,17858,93,596,589,1066,496,470,1932,233120,1.0553191489361702,683.3125200082317
1109,1094,17858,486,563,739,804,253,241,988,60973,1.049792531120332,349.4137948049561
1110,1562,4034,91,477,243,659,152,182,668,27664,0.8351648351648352,237.12443990445186
1111,969,4034,125,503,183,625,58,122,360,7076,0.4754098360655738,135.08515832614626
1112,1389,4034,95,475,228,658,133,183,632,24339,0.726775956284153,226.22555116520326
1113,972,4034,91,476,223,609,132,133,530,17556,0.9924812030075189,187.3846311734236
1114,1506,4034,93,480,246,661,153,181,668,27693,0.8453038674033149,237.00210969525145
1115,506,34465,103,312,554,782,451,470,1842,211970,0.9595744680851064,651.3839113763864
1116,1704,34465,42,325,700,749,658,424,2164,278992,1.55188679245283,782.7771074833499
1117,169,34465,147,345,503,742,356,397,1506,141332,0.8967254408060453,533.2400960167943
1118,266,26948,136,468,436,692,300,224,1048,67200,1.3392857142857142,374.4008546998791
1119,831,26948,185,508,463,686,278,178,912,49484,1.5617977528089888,330.1030142243479
1120,1458,26948,229,479,436,687,207,208,830,43056,0.9951923076923076,293.4501661270615
1121,1498,30482,72,793,720,1259,648,466,2228,301968,1.390557939914163,798.1603848851432
1122,808,30482,64,832,718,1248,654,416,2140,272064,1.5721153846153846,775.0948329075611
1123,140,30482,172,845,588,1265,416,420,1672,174720,0.9904761904761904,591.1480356052957
1124,650,12662,64,617,368,850,304,233,1074,70832,1.3047210300429184,383.020887158912
1125,968,12662,72,608,377,880,305,272,1154,82960,1.1213235294117647,408.667346383339
1126,909,12662,88,632,251,817,163,185,696,30155,0.8810810810810811,246.56439321199645
1127,1668,12662,62,619,345,876,283,257,1080,72731,1.1011673151750974,382.2800020927069
1128,433,12662,72,633,330,865,258,232,980,59856,1.112068965517241,346.9697393145402
1129,1672,12662,56,623,326,825,270,202,944,54540,1.3366336633663367,337.2002372478406
1130,1389,12662,46,604,366,876,320,272,1184,87040,1.1764705882352942,419.980951949014
1131,963,12662,75,654,321,866,246,212,916,52152,1.160377358490566,324.7460546334628
1132,951,33980,49,723,182,809,133,86,438,11438,1.5465116279069768,158.38244852255568
1133,410,33980,60,720,161,806,101,86,374,8686,1.1744186046511629,132.6536844569347
1134,952,33980,63,727,184,808,121,81,404,9801,1.4938271604938271,145.60906565183365
1135,1411,27986,48,626,235,776,187,150,674,28050,1.2466666666666666,239.7269279826528
1136,616,27986,78,630,210,743,132,113,490,14916,1.168141592920354,173.761330565808
1137,886,27986,68,622,213,775,145,153,596,22185,0.9477124183006536,210.79373804740976
1138,1431,20021,127,601,478,869,351,268,1238,94068,1.3097014925373134,441.61634933503086
1139,1552,20021,152,594,484,892,332,298,1260,98936,1.1140939597315436,446.12554286882073
1140,1012,20021,84,592,545,898,461,306,1534,141066,1.5065359477124185,553.3145579143928
1141,1281,20021,167,588,489,895,322,307,1258,98854,1.0488599348534202,444.8966172044917
1142,843,20021,153,604,448,857,295,253,1096,74635,1.16600790513834,388.63093031821336
1143,1335,20021,178,609,426,827,248,218,932,54064,1.1376146788990826,330.1938824387878
1144,1614,20021,170,584,428,900,258,316,1148,81528,0.8164556962025317,407.9460748677452
1145,234,20021,191,592,462,816,271,224,990,60704,1.2098214285714286,351.5920931989228
1146,1717,20021,174,586,416,814,242,228,940,55176,1.0614035087719298,332.48759375351136
1147,1104,29822,44,362,560,930,516,568,2168,293088,0.908450704225352,767.385170562997
1148,1310,29822,22,450,94,778,72,328,800,23616,0.2195121951219512,335.8094697890457
1149,784,29822,196,543,369,673,173,130,606,22490,1.3307692307692307,216.40009242142204
1150,463,29822,26,379,523,941,497,562,2118,279314,0.8843416370106761,750.2352964237286
1151,841,29822,153,374,565,1001,412,627,2078,258324,0.6570972886762361,750.2486254569214
1152,1225,29822,72,387,582,882,510,495,2010,252450,1.0303030303030305,710.721464428928
1153,675,29822,31,507,525,774,494,267,1522,131898,1.850187265917603,561.5380663855301
1154,886,29822,35,430,582,972,547,542,2178,296474,1.0092250922509225,770.0474011383975
1155,8,29822,20,294,597,958,577,664,2482,383128,0.8689759036144579,879.673234786645
1156,113,29822,145,574,501,925,356,351,1414,124956,1.0142450142450143,499.9369960304998
1157,1219,29822,57,412,517,982,460,570,2060,262200,0.8070175438596491,732.4616030891995
1158,1532,25997,68,540,238,690,170,150,640,25500,1.1333333333333333,226.71568097509268
1159,507,25997,74,533,224,614,150,81,462,12150,1.851851851851852,170.47287174210447
1160,671,25997,32,533,33,534,1,1,4,1,1.0,1.4142135623730951
1161,1368,25997,90,649,126,660,36,11,94,396,3.272727272727273,37.64306044943742
1162,1411,25997,30,532,221,700,191,168,718,32088,1.136904761904762,254.37177516383377
1163,1470,25997,88,532,228,612,140,80,440,11200,1.75,161.24515496597098
1164,1218,25997,68,532,219,696,151,164,630,24764,0.9207317073170732,222.92823957498072
1165,1046,25997,156,605,195,668,39,63,204,2457,0.6190476190476191,74.09453421137081
1166,1264,25997,29,527,230,699,201,172,746,34572,1.1686046511627908,264.5467822522134
1167,1200,22886,228,1380,273,1446,45,66,222,2970,0.6818181818181818,79.88116173416608
1168,134,22886,49,1317,393,1529,344,212,1112,72928,1.6226415094339623,404.0792001575929
1169,901,22886,182,1337,380,1489,198,152,700,30096,1.3026315789473684,249.61570463414355
1170,91,22886,50,1318,362,1550,312,232,1088,72384,1.3448275862068966,388.80329216713176
1171,247,22886,71,1331,175,1404,104,73,354,7592,1.4246575342465753,127.06297651164952
1172,298,22886,215,1339,300,1472,85,133,436,11305,0.6390977443609023,157.84169284444462
1173,488,22886,54,1328,314,1535,260,207,934,53820,1.2560386473429952,332.3386826717588
1174,1350,22886,49,1315,405,1552,356,237,1186,84372,1.5021097046413503,427.6739412215806
1175,1241,22886,211,1344,308,1489,97,145,484,14065,0.6689655172413793,174.45343218177166
1176,100,32525,60,922,495,1151,435,229,1328,99615,1.899563318777293,491.5953620611163
1177,1513,32525,74,914,493,1149,419,235,1308,98465,1.7829787234042551,480.40191506695726
1178,656,32525,64,955,483,1158,419,203,1244,85057,2.064039408866995,465.5856526999087
1179,916,6163,131,403,683,861,552,458,2020,252816,1.205240174672489,717.2642469829373
1180,1092,6163,93,459,745,854,652,395,2094,257540,1.650632911392405,762.3181750424162
1181,1621,6163,111,486,805,841,694,355,2098,246370,1.9549295774647888,779.5261381121226
1182,52,6163,30,406,788,890,758,484,2484,366872,1.5661157024793388,899.3442055186657
1183,830,6163,230,541,785,786,555,245,1600,135975,2.26530612244898,606.6712454039667
1184,1459,6163,171,463,687,844,516,381,1794,196596,1.3543307086614174,641.4179604594807
1185,1682,22679,21,392,792,858,771,466,2474,359286,1.6545064377682404,900.8867853398672
1186,1163,22679,36,399,741,891,705,492,2394,346860,1.4329268292682926,859.7028556425761
1187,55,22679,43,406,701,812,658,406,2128,267148,1.6206896551724137,773.1752712031083
1188,222,33016,74,575,348,940,274,365,1278,100010,0.7506849315068493,456.40004382120736
1189,453,33016,49,581,382,828,333,247,1160,82251,1.3481781376518218,414.6058369101911
1190,884,33016,28,558,443,977,415,419,1668,173885,0.9904534606205252,589.733838269435
1191,22,24247,129,461,871,841,742,380,2244,281960,1.9526315789473685,833.6450083818652
1192,957,24247,151,479,802,782,651,303,1908,197253,2.1485148514851486,718.059886081934
1193,1238,24247,172,486,762,831,590,345,1870,203550,1.710144927536232,683.4654343856754
1194,1508,13751,22,276,224,596,202,320,1044,64640,0.63125,378.42304369580876
1195,909,13751,50,307,466,553,416,246,1324,102336,1.6910569105691058,483.2928718696356
1196,903,13751,22,315,485,596,463,281,1488,130103,1.6476868327402134,541.5994830130472
1197,1439,13751,10,227,527,602,517,375,1784,193875,1.3786666666666667,638.6814542477338
1198,1389,13751,108,278,392,467,284,189,946,53676,1.5026455026455026,341.1407334224396
1199,1383,13751,25,253,516,608,491,355,1692,174305,1.3830985915492957,605.8927297797853
1200,1241,13751,22,297,486,602,464,305,1538,141520,1.5213114754098358,555.2666026333657
1201,1207,13751,53,262,524,596,471,334,1610,157314,1.4101796407185632,577.4054035077954
1202,520,2766,251,578,431,782,180,204,768,36720,0.8823529411764706,272.05881717011124
1203,331,2766,273,609,408,731,135,122,514,16470,1.1065573770491803,181.95878654244757
1204,192,2766,240,596,407,811,167,215,764,35905,0.7767441860465116,272.23886570436633
1205,579,2766,187,591,451,808,264,217,962,57288,1.216589861751152,341.73820389298004
1206,404,2766,63,583,439,847,376,264,1280,99264,1.4242424242424243,459.42572849155937
1207,1554,2766,35,574,451,848,416,274,1380,113984,1.5182481751824817,498.1284974783113
1208,577,2766,114,576,408,849,294,273,1134,80262,1.0769230769230769,401.2044366653988
1209,963,24143,57,814,303,1064,246,250,992,61500,0.9840000000000001,350.736368231183
1210,1555,24143,102,730,572,1101,470,371,1682,174370,1.2668463611859841,598.782932288488
1211,1383,24143,62,736,303,1124,241,388,1258,93508,0.6211340206185567,456.75485766437123
1212,251,24143,50,723,590,1118,540,395,1870,213300,1.3670886075949369,669.0478308760892
1213,140,24143,102,734,327,1058,225,324,1098,72900,0.6944444444444444,394.46292601460027
1214,527,24143,34,716,578,1118,544,402,1892,218688,1.3532338308457712,676.4170311279869
1215,971,24143,61,725,590,1123,529,398,1854,210542,1.3291457286432158,662.0007552865782
1216,805,24143,159,777,320,929,161,152,626,24472,1.0592105263157894,221.41589825484527
1217,592,24143,44,714,584,1122,540,408,1896,220320,1.3235294117647058,676.8042553057716
1218,247,24143,134,773,322,965,188,192,760,36096,0.9791666666666666,268.71546289709494
1219,1554,2724,30,504,323,677,293,173,932,50689,1.69364161849711,340.26166401756166
1220,889,2724,53,509,324,677,271,168,878,45528,1.613095238095238,318.8494942759044
1221,520,2724,78,501,323,671,245,170,830,41650,1.4411764705882353,298.2029510249689
1222,1651,2724,46,518,324,669,278,151,858,41978,1.8410596026490067,316.36213427020624
1223,1656,2724,43,519,322,662,279,143,844,39897,1.9510489510489508,313.5123602029113
1224,1006,2724,48,512,318,678,270,166,872,44820,1.6265060240963856,316.9479452528443
1225,577,2724,34,507,313,668,279,161,880,44919,1.7329192546583851,322.12109524214645
1226,950,2724,160,530,326,643,166,113,558,18758,1.4690265486725664,200.81085628023203
1227,579,2724,182,515,325,664,143,149,584,21307,0.9597315436241609,206.51876428063383
1228,404,2724,37,515,314,664,277,149,852,41273,1.859060402684564,314.5313974788527
1229,1437,2724,29,521,317,661,288,140,856,40320,2.057142857142857,320.22492095400696
1230,903,18,126,774,694,1010,568,236,1608,134048,2.406779661016949,615.0772309230769
1231,1723,18,144,634,764,1132,620,498,2236,308760,1.2449799196787148,795.238329056139
1232,656,32636,59,707,250,898,191,191,764,36481,1.0,270.1147904132612
1233,46,32636,89,726,203,872,114,146,520,16644,0.7808219178082192,185.23498589629335
1234,1679,32636,118,711,249,913,131,202,666,26462,0.6485148514851485,240.75921581530375
1235,238,13115,131,615,729,1182,598,567,2330,339066,1.0546737213403878,824.0709920874536
1236,804,13115,97,627,1003,1243,906,616,3044,558096,1.4707792207792207,1095.5783860591628
1237,1715,13115,108,565,935,1254,827,689,3032,569803,1.2002902757619738,1076.4060572107535
1238,334,13115,191,552,1012,1254,821,702,3046,576342,1.1695156695156694,1080.2059988724372
1239,1537,13115,255,648,720,1065,465,417,1764,193905,1.1151079136690647,624.5910662185299
1240,1282,13115,214,665,769,1203,555,538,2186,298590,1.0315985130111525,772.9611891938689
1241,571,13115,153,561,899,1217,746,656,2804,489376,1.1371951219512195,993.4042480279617
1242,886,28619,44,783,607,1138,563,355,1836,199865,1.5859154929577466,665.5779443461149
1243,178,28619,49,779,595,1121,546,342,1776,186732,1.5964912280701755,644.2670253862136
1244,62,28619,42,797,596,1119,554,322,1752,178388,1.7204968944099381,640.7807737440318
1245,1207,13720,160,743,524,1364,364,621,1970,226044,0.5861513687600645,719.8173379406751
1246,1241,13720,214,870,455,1101,241,231,944,55671,1.0432900432900434,333.8292976956936
1247,1383,13720,157,847,460,1277,303,430,1466,130290,0.7046511627906977,526.0313678859845
1248,1508,13720,108,866,546,1092,438,226,1328,98988,1.9380530973451329,492.86915099243123
1249,903,13720,87,857,494,1306,407,449,1712,182743,0.9064587973273942,606.0115510450275
1250,700,13720,233,914,431,1299,198,385,1166,76230,0.5142857142857142,432.9307103913974
1251,1389,13720,178,847,502,1111,324,264,1176,85536,1.2272727272727273,417.93779441443195
1252,562,3770,91,642,287,810,196,168,728,32928,1.1666666666666667,258.14724480420085
1253,1263,3770,74,630,291,826,217,196,826,42532,1.1071428571428572,292.41238003887594
1254,462,3770,90,712,210,786,120,74,388,8880,1.6216216216216215,140.98226838861686
1255,1371,3770,38,624,301,829,263,205,936,53915,1.2829268292682927,333.45764348714516
1256,615,3770,69,651,253,817,184,166,700,30544,1.108433734939759,247.81444671366518
1257,1635,3770,62,631,299,810,237,179,832,42423,1.324022346368715,297.00168349691216
1258,401,3770,80,676,262,824,182,148,660,26936,1.2297297297297298,234.58047659598614
1259,1045,3770,80,673,137,770,57,97,308,5529,0.5876288659793815,112.50777750893491
1260,124,8204,46,335,154,428,108,93,402,10044,1.1612903225806452,142.52368224263643
1261,341,8204,55,352,138,427,83,75,316,6225,1.106666666666667,111.8659912573969
1262,421,8204,19,332,154,439,135,107,484,14445,1.2616822429906542,172.2614292289484
1263,18,8204,19,331,156,439,137,108,490,14796,1.2685185185185186,174.4505660638566
1264,1379,8204,90,357,113,404,23,47,140,1081,0.4893617021276596,52.32590180780452
1265,1373,8204,64,342,152,431,88,89,354,7832,0.9887640449438202,125.15989773086265
1266,1001,8204,43,431,123,436,80,5,170,400,16.0,80.15609770940699
1267,25,8204,59,335,131,407,72,72,288,5184,1.0,101.82337649086284
1268,571,13162,218,840,658,1354,440,514,1908,226160,0.8560311284046692,676.6062370389442
1269,1053,13162,207,833,732,1390,525,557,2164,292425,0.9425493716337524,765.4240654695932
1270,243,13162,195,800,727,1384,532,584,2232,310688,0.9109589041095891,789.9873416707384
1271,334,13162,188,809,703,1364,515,555,2140,285825,0.927927927927928,757.1327492586753
1272,1715,13162,270,860,608,1293,338,433,1542,146354,0.7806004618937644,549.3022847212635
1273,804,13162,183,816,766,1391,583,575,2316,335225,1.0139130434782608,818.8491924646443
1274,1473,19413,43,407,170,507,127,100,454,12700,1.27,161.64467204334326
1275,1471,19413,45,413,179,504,134,91,450,12194,1.4725274725274726,161.9783936208777
1276,66,19413,33,403,173,519,140,116,512,16240,1.206896551724138,181.8130908378162
1277,1598,15677,101,799,271,935,170,136,612,23120,1.25,217.70622407271685
1278,1107,15677,121,814,263,927,142,113,510,16046,1.2566371681415929,181.47451611727746
1279,1174,15677,118,817,270,934,152,117,538,17784,1.2991452991452992,191.81501505356664
1280,219,15677,121,825,214,913,93,88,362,8184,1.056818181818182,128.03515142334936
1281,1117,15677,115,807,270,922,155,115,540,17825,1.3478260869565215,193.00259065618783
1282,58,15677,109,788,267,915,158,127,570,20066,1.2440944881889764,202.71408436514716
1283,60,1650,35,587,227,719,192,132,648,25344,1.4545454545454546,232.99785406737118
1284,886,1650,35,623,143,716,108,93,402,10044,1.1612903225806452,142.52368224263643
1285,1112,1650,91,615,143,683,52,68,240,3536,0.7647058823529411,85.60373823613078
1286,1472,1650,84,623,105,670,21,47,136,987,0.44680851063829785,51.478150704935004
1287,1101,1650,36,596,166,717,130,121,502,15730,1.0743801652892562,177.59786034747154
1288,1311,1650,62,614,149,699,87,85,344,7395,1.0235294117647058,121.63058825805291
1289,1535,1650,79,632,153,706,74,74,296,5476,1.0,104.65180361560904
1290,1099,1650,46,592,193,695,147,103,500,15141,1.4271844660194175,179.49373248110922
1291,574,311,164,628,519,1253,355,625,1960,221875,0.568,718.7836948623695
1292,1652,311,207,594,557,972,350,378,1456,132300,0.925925925925926,515.1543458032747
1293,1655,311,236,641,549,784,313,143,912,44759,2.1888111888111887,344.11916540640397
1294,748,311,171,635,434,1100,263,465,1456,122295,0.5655913978494623,534.2227999627122
1295,946,311,224,593,541,1034,317,441,1516,139797,0.7188208616780045,543.111406619305
1296,338,311,94,638,439,1031,345,393,1476,135585,0.8778625954198473,522.9474160945821
1297,193,311,168,612,557,1051,389,439,1656,170771,0.8861047835990888,586.55093555462
1298,518,311,179,608,557,965,378,357,1470,134946,1.0588235294117647,519.9355729318778
1299,952,311,261,644,467,915,206,271,954,55826,0.7601476014760148,340.4071092089588
1300,190,311,207,658,444,1011,237,353,1180,83661,0.6713881019830028,425.17996189848833
1301,119,33868,154,306,472,526,318,220,1076,69960,1.4454545454545455,386.6833329741534
1302,929,33868,154,283,493,555,339,272,1222,92208,1.2463235294117647,434.63202827219254
1303,1271,33868,172,307,480,550,308,243,1102,74844,1.2674897119341564,392.3174734828924
1304,509,33868,193,352,278,454,85,102,374,8670,0.8333333333333334,132.7742444904131
1305,925,33868,144,298,494,540,350,242,1184,84700,1.4462809917355373,425.5161571550486
1306,1222,33868,160,306,418,542,258,236,988,60888,1.0932203389830508,349.6569747624091
1307,1199,35544,246,617,348,787,102,170,544,17340,0.6,198.25236442474022
1308,1508,35544,26,596,380,826,354,230,1168,81420,1.5391304347826087,422.1563691335238
1309,1674,35544,233,608,337,765,104,157,522,16328,0.6624203821656051,188.32153355365392
1310,427,35544,33,559,392,789,359,230,1178,82570,1.5608695652173914,426.3578309354714
1311,94,35544,32,565,406,780,374,215,1178,80410,1.73953488372093,431.39425123661533
1312,1508,35512,34,940,197,1105,163,165,656,26895,0.987878787878788,231.93533581582605
1313,200,35512,33,938,208,1116,175,178,706,31150,0.9831460674157304,249.6177077052027
1314,534,35512,36,940,176,1124,140,184,648,25760,0.7608695652173914,231.2055362658948
1315,1674,35512,39,938,147,1102,108,164,544,17712,0.6585365853658537,196.36700333813724
1316,94,35512,37,939,155,1089,118,150,536,17700,0.7866666666666666,190.85072700935672
1317,1608,23528,43,875,527,1178,484,303,1574,146652,1.5973597359735974,571.0210153750911
1318,576,23528,77,916,514,1178,437,262,1398,114494,1.66793893129771,509.5223253204907
1319,957,23528,40,912,532,1172,492,260,1504,127920,1.892307692307692,556.4746175702895
1320,1378,23528,80,907,518,1169,438,262,1400,114756,1.6717557251908397,510.3802504016001
1321,15,23528,58,922,519,1155,461,233,1388,107413,1.9785407725321889,516.5365427537533
1322,952,23528,106,937,508,1087,402,150,1104,60300,2.68,429.073420290747
1323,1483,23528,90,942,504,1122,414,180,1188,74520,2.3,451.43770334344026
1324,1127,31794,452,656,789,879,337,223,1120,75151,1.5112107623318385,404.1014724051374
1325,1230,31794,115,578,959,1059,844,481,2650,405964,1.7546777546777548,971.4406826976107
1326,957,31794,92,517,937,1038,845,521,2732,440245,1.621880998080614,992.7064017120067
1327,182,31794,40,568,918,1080,878,512,2780,449536,1.71484375,1016.3798502528472
1328,911,18191,51,1370,87,1397,36,27,126,972,1.3333333333333333,45.0
1329,254,18191,53,1371,85,1396,32,25,114,800,1.28,40.607881008493905
1330,480,18191,54,1373,77,1394,23,21,88,483,1.0952380952380951,31.144823004794873
1331,246,18191,52,1370,87,1397,35,27,124,945,1.2962962962962965,44.204072210600685
1332,1147,18191,56,1371,74,1393,18,22,80,396,0.8181818181818182,28.42534080710379
1334,998,23477,75,985,203,1081,128,96,448,12288,1.3333333333333333,160.0
1335,930,23477,63,984,204,1082,141,98,478,13818,1.4387755102040816,171.71196813268432
1336,798,23477,66,982,214,1085,148,103,502,15244,1.4368932038834952,180.31361568112376
1337,1223,19469,34,715,396,1018,362,303,1330,109686,1.1947194719471947,472.07308756166134
1338,781,19469,66,766,382,1008,316,242,1116,76472,1.3057851239669422,398.02009999496255
1339,997,19469,51,727,410,1016,359,289,1296,103751,1.2422145328719725,460.87091468219165
1340,1383,14077,119,173,809,834,690,661,2702,456090,1.0438729198184569,955.5213236762432
1341,903,14077,387,344,800,759,413,415,1656,171395,0.9951807228915662,585.4861228073643
1342,1508,14077,76,249,747,768,671,519,2380,348249,1.2928709055876686,848.2935812559234
1343,1207,14077,65,207,827,809,762,602,2728,458724,1.26578073089701,971.1065852932932
1344,1389,14077,31,194,845,843,814,649,2926,528286,1.2542372881355932,1041.055714167114
1345,1241,14077,465,400,791,771,326,371,1394,120946,0.8787061994609164,493.87953996900904
1346,902,16465,71,283,707,830,636,547,2366,347892,1.1627056672760512,838.8712654513802
1347,755,16465,51,254,709,840,658,586,2488,385588,1.1228668941979525,881.1129326028531
1348,1071,16465,119,238,585,855,466,617,2166,287522,0.7552674230145867,773.2043714309949
1349,36,16465,28,255,728,878,700,623,2646,436100,1.1235955056179776,937.0853749792492
1350,644,16465,21,228,701,811,680,583,2526,396440,1.1663807890222984,895.7058669005132
1351,909,16465,125,252,633,876,508,624,2264,316992,0.8141025641025641,804.636563921874
1352,1344,16465,65,291,681,732,616,441,2114,271656,1.3968253968253967,757.5862987145425
1353,1730,16465,31,299,686,819,655,520,2350,340600,1.2596153846153846,836.3163277133838
1354,1557,16465,65,235,693,804,628,569,2394,357332,1.1036906854130053,847.4343632400092
1355,502,7133,63,185,558,649,495,464,1918,229680,1.0668103448275863,678.4696013824054
1356,1045,7133,113,239,558,583,445,344,1578,153080,1.2936046511627908,562.4597763396064
1357,328,7133,98,174,577,640,479,466,1890,223214,1.0278969957081543,668.2791332968583
1358,66,7133,105,197,523,651,418,454,1744,189772,0.920704845814978,617.122354156775
1359,1036,7133,134,164,572,628,438,464,1804,203232,0.9439655172413792,638.0752306742521
1360,1562,23003,33,441,111,496,78,55,266,4290,1.4181818181818182,95.44108130150245
1361,1241,23003,51,445,83,482,32,37,138,1184,0.8648648648648649,48.91829923454004
1362,1350,23003,22,431,122,505,100,74,348,7400,1.351351351351351,124.4025723206719
1363,761,23003,30,443,111,496,81,53,268,4293,1.5283018867924532,96.79876032264049
1364,1508,23003,37,442,78,494,41,52,186,2132,0.7884615384615384,66.21933252457322
1365,706,24639,122,659,216,768,94,109,406,10246,0.8623853211009175,143.93401265857906
1366,1030,24639,39,666,302,834,263,168,862,44184,1.5654761904761905,312.07851576165893
1367,657,24639,87,676,314,847,227,171,796,38817,1.3274853801169588,284.20063335608523
1368,1152,24639,44,632,356,859,312,227,1078,70824,1.3744493392070485,385.84064067954273
1369,1090,24639,49,651,317,830,268,179,894,47972,1.4972067039106145,322.28093334853054
1370,375,24639,44,656,385,863,341,207,1096,70587,1.647342995169082,398.911017646793
1371,1630,24639,71,650,347,792,276,142,836,39192,1.9436619718309858,310.3868553917836
1372,666,24639,78,654,360,837,282,183,930,51606,1.540983606557377,336.17406205714326
1373,1746,24639,47,651,348,860,301,209,1020,62909,1.440191387559809,366.44508456247576
1374,998,23404,61,241,665,756,604,515,2238,311060,1.1728155339805826,793.7512204715026
1375,798,23404,27,258,903,835,876,577,2906,505452,1.5181975736568458,1048.9542411373338
1376,220,23404,57,270,570,715,513,445,1916,228285,1.152808988764045,679.1126563391379
1377,501,23404,50,239,552,708,502,469,1942,235438,1.0703624733475479,686.9970887856804
1378,930,23404,38,252,894,829,856,577,2866,493912,1.4835355285961866,1032.3105153005079
1379,525,31746,274,802,760,1153,486,351,1674,170586,1.3846153846153846,599.497289401712
1380,947,31746,58,778,811,1403,753,625,2756,470625,1.2048,978.587757945091
1381,182,31746,45,810,819,1351,774,541,2630,418734,1.4306839186691311,944.3288622084999
1382,335,31746,172,815,787,1255,615,440,2110,270600,1.3977272727272727,756.191113409831
1383,577,31746,64,826,768,1416,704,590,2588,415360,1.1932203389830511,918.5401461014102
1384,129,31746,43,795,862,1409,819,614,2866,502866,1.3338762214983713,1023.6000195388822
1385,957,31746,64,778,825,1423,761,645,2812,490845,1.17984496124031,997.5700476658268
1386,1230,31746,259,846,783,1232,524,386,1820,202264,1.3575129533678756,650.8240929775111
1387,1169,1620,126,320,943,919,817,599,2832,489383,1.3639398998330552,1013.0597218328246
1388,1225,1620,128,335,948,915,820,580,2800,475600,1.4137931034482758,1004.3903623591775
1389,1099,1620,226,328,943,905,717,577,2588,413709,1.24263431542461,920.3358082786956
1390,924,1620,214,401,597,806,383,405,1576,155115,0.9456790123456791,557.4172584339311
1391,1101,1620,132,344,950,907,818,563,2762,460534,1.452930728241563,993.0221548384508
1392,1602,1620,311,460,736,894,425,434,1718,184450,0.97926267281106,607.4380626862297
1393,886,1620,108,327,937,899,829,572,2802,474188,1.4493006993006994,1007.1866758451483
1394,880,1620,166,310,926,902,760,592,2704,449920,1.2837837837837838,963.3607839226174
1395,147,29674,84,666,186,874,102,208,620,21216,0.4903846153846154,231.66354913969525
1396,145,29674,135,701,171,744,36,43,158,1548,0.8372093023255814,56.08029957123981
1397,590,29674,70,669,201,851,131,182,626,23842,0.7197802197802198,224.24317157942625
1398,1453,29674,39,679,195,870,156,191,694,29796,0.8167539267015707,246.61102976144437
1399,1496,29674,81,687,192,871,111,184,590,20424,0.6032608695652174,214.88834309938733
1400,1068,29674,87,693,191,867,104,174,556,18096,0.5977011494252874,202.71161782196896
1401,288,14376,67,803,178,872,111,69,360,7659,1.608695652173913,130.6981254647518
1402,739,14376,78,789,165,881,87,92,358,8004,0.9456521739130436,126.62148316932637
1403,628,14376,91,807,168,884,77,77,308,5929,1.0,108.89444430272832
1404,947,14376,83,805,179,880,96,75,342,7200,1.28,121.82364302548172
1405,17,14376,55,791,149,880,94,89,366,8366,1.0561797752808988,129.4488315899375
1406,1048,14376,63,798,175,880,112,82,388,9184,1.3658536585365857,138.80922159568507
1407,1484,14376,83,793,175,883,92,90,364,8280,1.022222222222222,128.70120434556935
1408,336,14376,70,798,177,874,107,76,366,8132,1.4078947368421053,131.24404748406687
1409,748,14376,90,815,140,845,50,30,160,1500,1.6666666666666667,58.309518948453004
1410,1401,4693,180,742,407,925,227,183,820,41541,1.2404371584699454,291.5784628534831
1411,873,4693,108,644,465,1021,357,377,1468,134589,0.946949602122016,519.2090137892446
1412,1357,4693,103,667,475,953,372,286,1316,106392,1.3006993006993006,469.23341739479724
1413,1254,4693,105,672,432,940,327,268,1190,87636,1.2201492537313432,422.79191099168395
1414,100,4693,56,630,585,1061,529,431,1920,227999,1.2273781902552203,682.3503498936599
1415,1396,4693,107,640,507,1032,400,392,1584,156800,1.020408163265306,560.0571399419885
1416,1404,4693,48,632,448,1034,400,402,1604,160800,0.9950248756218906,567.1014018674261
1417,634,24267,28,619,98,669,70,50,240,3500,1.4,86.02325267042627
1418,803,24267,33,617,89,666,56,49,210,2744,1.1428571428571428,74.41102068914255
1419,242,24267,37,617,101,668,64,51,230,3264,1.2549019607843137,81.83520025025906
1420,466,24267,40,618,101,671,61,53,228,3233,1.150943396226415,80.8084154033477
1421,952,24267,62,631,89,660,27,29,112,783,0.9310344827586208,39.6232255123179
1422,957,24267,31,623,109,671,78,48,252,3744,1.625,91.58602513484249
1423,963,11410,133,759,591,957,458,198,1312,90684,2.313131313131313,498.96693277210267
1424,140,11410,70,630,739,1082,669,452,2242,302388,1.4800884955752212,807.3815702627847
1425,35,11410,82,711,608,1018,526,307,1666,161482,1.7133550488599352,609.0361237233798
1426,1197,11410,422,684,682,908,260,224,968,58240,1.1607142857142858,343.1850812608264
1427,1565,11410,81,636,696,1109,615,473,2176,290895,1.3002114164904863,775.8569455769536
1428,909,11410,143,624,579,1175,436,551,1974,240236,0.7912885662431942,702.6357520081084
1429,202,11410,359,641,663,1036,304,395,1398,120080,0.7696202531645571,498.4385619110945
1430,299,11410,175,687,558,1135,383,448,1662,171584,0.8549107142857143,589.4005429247584
1431,150,11410,177,684,666,1007,489,323,1624,157947,1.5139318885448916,586.046073274107
1432,487,11410,199,687,574,1013,375,326,1402,122250,1.1503067484662577,496.89133620943727
1433,810,11410,71,698,599,1055,528,357,1770,188496,1.4789915966386555,637.3641031623918
1434,818,28493,90,439,508,769,418,330,1496,137940,1.2666666666666666,532.5636112240489
1435,862,28493,107,436,508,791,401,355,1512,142355,1.1295774647887324,535.5613877045282
1436,1442,28493,102,466,468,707,366,241,1214,88206,1.5186721991701244,438.22026425075325
1437,1206,28493,174,506,419,712,245,206,902,50470,1.1893203883495145,320.09529830973776
1438,698,28493,79,446,498,785,419,339,1516,142041,1.2359882005899705,538.9638206781602
1439,1198,28493,133,471,475,744,342,273,1230,93366,1.2527472527472527,437.59913162619506
1440,577,3079,21,359,93,427,72,68,280,4896,1.0588235294117647,99.03534722511958
1441,242,3079,17,353,96,426,79,73,304,5767,1.082191780821918,107.56393447619885
1442,471,3079,16,360,79,417,63,57,240,3591,1.1052631578947372,84.95881355103778
1443,464,3079,23,361,61,428,38,67,210,2546,0.5671641791044776,77.02596964660685
1444,407,3079,26,370,54,408,28,38,132,1064,0.7368421052631579,47.20169488482379
1445,1491,3079,17,359,72,426,55,67,244,3685,0.8208955223880597,86.68333173107735
1446,712,8108,33,304,806,903,773,599,2744,463027,1.2904841402337228,977.9212647243131
1447,265,8108,17,291,822,953,805,662,2934,532910,1.2160120845921452,1042.242294286698
1448,1361,8108,47,302,861,937,814,635,2898,516890,1.2818897637795277,1032.3860711962361
1449,556,21099,96,1165,319,1390,223,225,896,50175,0.9911111111111112,316.7869946825469
1450,1158,21099,103,1186,311,1379,208,193,802,40144,1.077720207253886,283.74812774712717
1451,1689,21099,118,1203,305,1376,187,173,720,32351,1.0809248554913296,254.7508586835381
1452,1145,19999,314,682,544,952,230,270,1000,62100,0.8518518518518519,354.682957019364
1453,1290,19999,316,642,519,913,203,271,948,55013,0.7490774907749077,338.60005906674024
1454,426,19999,375,662,417,875,42,213,510,8946,0.19718309859154928,217.1013588165675
1455,592,19999,282,657,543,961,261,304,1130,79344,0.8585526315789473,400.67068772247364
1456,865,19999,337,639,523,940,186,301,974,55986,0.6179401993355482,353.8318809830454
1457,525,8610,77,485,293,695,216,210,852,45360,1.0285714285714285,301.2573650551966
1458,29,8610,72,490,300,707,228,217,890,49476,1.0506912442396312,314.75863768926183
1459,1050,8610,51,465,294,729,243,264,1014,64152,0.9204545454545454,358.81053496239485
1460,1409,22053,98,219,771,689,673,470,2286,316310,1.4319148936170212,820.8708790059494
1461,119,22053,120,210,746,716,626,506,2264,316756,1.2371541501976284,804.9298106046266
1462,678,22053,55,190,711,776,656,586,2484,384416,1.1194539249146758,879.6203726608428
1463,1399,5588,90,818,443,1205,353,387,1480,136611,0.9121447028423773,523.8110346298558
1464,1694,5588,164,835,414,1188,250,353,1206,88250,0.7082152974504249,432.560978360277
1465,313,5588,120,791,469,1242,349,451,1600,157399,0.7738359201773836,570.2648507491936
1466,1738,5588,80,809,529,1289,449,480,1858,215520,0.9354166666666668,657.2678297315334
1467,155,5588,92,859,511,1406,419,547,1932,229193,0.7659963436928702,689.035557863308
1468,208,5588,35,833,623,1567,588,734,2644,431592,0.8010899182561307,940.4786015641185
1469,1097,5588,70,777,498,1184,428,407,1670,174196,1.0515970515970516,590.6208597738485
1470,1557,16477,69,456,275,574,206,118,648,24308,1.7457627118644068,237.40261161158273
1471,1730,16477,65,432,269,584,204,152,712,31008,1.3421052631578947,254.40125785852553
1472,644,16477,94,454,160,505,66,51,234,3366,1.2941176470588236,83.40863264674707
1473,36,16477,72,485,292,567,220,82,604,18040,2.6829268292682933,234.78500803926983
1474,1452,16477,54,428,310,581,256,153,818,39168,1.673202614379085,298.23648334836565
1475,1501,16477,19,401,311,620,292,219,1022,63948,1.3333333333333333,365.0
1476,651,16477,74,481,181,593,107,112,438,11984,0.9553571428571428,154.8967397978408
1477,902,16477,19,447,310,581,291,134,850,38994,2.171641791044776,320.3700984798675
1478,909,16477,85,508,276,568,191,60,502,11460,3.183333333333333,200.2023975880409
1479,297,18723,46,898,134,988,88,90,356,7920,0.9777777777777776,125.8729518204765
1480,1728,18723,46,902,131,987,85,85,340,7225,1.0,120.20815280171308
1481,699,18723,55,924,133,977,78,53,262,4134,1.4716981132075468,94.30270409696638
1482,213,8761,50,908,68,926,18,18,72,324,1.0,25.45584412271571
1483,448,8761,54,909,66,927,12,18,60,216,0.6666666666666666,21.633307652783937
1484,154,8761,50,901,69,925,19,24,86,456,0.7916666666666666,30.610455730027933
1485,579,2740,283,359,329,562,46,203,498,9338,0.2266009852216749,208.1465829649865
1486,520,2740,199,327,696,728,497,401,1796,199297,1.2394014962593516,638.6000313185085
1487,1656,2740,234,388,723,707,489,319,1616,155991,1.5329153605015673,583.8510083916958
1488,690,2740,216,366,698,653,482,287,1538,138334,1.6794425087108014,560.9750440081983
1489,404,2740,248,410,630,604,382,194,1152,74108,1.9690721649484535,428.43902716722715
1490,577,2740,226,387,620,604,394,217,1222,85498,1.8156682027649769,449.8055135277913
1491,889,2740,141,378,766,813,625,435,2120,271875,1.4367816091954022,761.4788243936925
1492,1554,2740,37,251,768,798,731,547,2556,399857,1.336380255941499,913.0005476449617
1493,1580,10195,25,497,112,562,87,65,304,5655,1.3384615384615384,108.60018416190647
1494,821,10195,28,497,100,559,72,62,268,4464,1.1612903225806452,95.01578816175763
1495,1210,10195,25,498,110,560,85,62,294,5270,1.3709677419354838,105.20931517693668
1496,659,10195,36,505,87,553,51,48,198,2448,1.0625,70.03570517957252
1497,831,10195,28,498,109,553,81,55,272,4455,1.4727272727272729,97.9081201943945
1498,1590,10195,27,498,108,558,81,60,282,4860,1.35,100.80178569846865
1499,919,21011,17,432,293,629,276,197,946,54372,1.401015228426396,339.09438214160963
1500,981,21011,46,443,329,579,283,136,838,38488,2.0808823529411766,313.9824835878588
1501,1521,21011,64,445,355,681,291,236,1054,68676,1.2330508474576272,374.6691874173802
1502,341,7279,62,465,328,879,266,414,1360,110124,0.6425120772946861,492.0894227678543
1503,1420,7279,73,460,308,887,235,427,1324,100345,0.550351288056206,487.3951169226052
1504,75,7279,110,493,254,888,144,395,1078,56880,0.3645569620253165,420.42954225410944
1505,1014,7279,31,399,335,875,304,476,1560,144704,0.6386554621848739,564.7937676709969
1506,1646,7279,105,452,236,741,131,289,840,37859,0.4532871972318339,317.3042703778189
1507,947,7279,55,434,313,879,258,445,1406,114810,0.5797752808988764,514.3821536562092
1508,1126,7279,78,452,277,727,199,275,948,54725,0.7236363636363636,339.44955442598535
1509,25,7279,92,493,96,519,4,26,60,104,0.15384615384615385,26.30589287593181
1510,742,7279,24,470,351,782,327,312,1278,102024,1.0480769230769231,451.9657066636804
1511,1133,7279,96,486,299,877,203,391,1188,79373,0.5191815856777494,440.55646630142655
1512,185,7279,102,498,299,691,197,193,780,38021,1.0207253886010363,275.7861490358064
1513,100,32588,169,608,591,948,422,340,1524,143480,1.241176470588235,541.9261942368167
1514,874,32588,295,594,561,952,266,358,1248,95228,0.7430167597765364,446.0044842823892
1515,825,32588,332,601,587,965,255,364,1238,92820,0.7005494505494505,444.4333470836769
1516,656,32588,271,614,598,987,327,373,1400,121971,0.8766756032171582,496.04233690280915
1517,1351,32588,330,692,555,969,225,277,1004,62325,0.8122743682310469,356.8669219751251
1518,1513,32588,85,507,709,985,624,478,2204,298272,1.3054393305439331,786.0407114138554
1519,843,20310,40,887,181,933,141,46,374,6486,3.065217391304348,148.3138563991915
1520,523,20310,41,810,234,949,193,139,664,26827,1.3884892086330936,237.84448700779257
1521,580,20310,53,856,171,950,118,94,424,11092,1.25531914893617,150.86417732516887
1522,854,20310,44,877,109,943,65,66,262,4290,0.9848484848484848,92.63368717696602
1523,30,20310,46,880,103,939,57,59,232,3363,0.9661016949152542,82.03657720797473
1524,476,20310,195,813,246,885,51,72,246,3672,0.7083333333333334,88.23264701911646
1525,71,20310,45,859,168,948,123,89,424,10947,1.3820224719101124,151.82226450688975
1526,1378,23358,202,824,284,1039,82,215,594,17630,0.3813953488372093,230.10649708341572
1527,952,23358,276,841,304,1226,28,385,826,10780,0.07272727272727272,386.01683901094265
1528,636,23358,39,734,438,1166,399,432,1662,172368,0.9236111111111112,588.0688735173798
1529,15,23358,45,786,432,1217,387,431,1636,166797,0.8979118329466357,579.2495144581478
1530,957,23358,39,776,430,1195,391,419,1620,163829,0.9331742243436754,573.0985953568548
1531,1483,23358,157,823,402,1122,245,299,1088,73255,0.8193979933110368,386.55659352803696
1532,752,23358,35,770,424,1207,389,437,1652,169993,0.8901601830663616,585.0555529178405
1533,242,24552,50,357,506,613,456,256,1424,116736,1.78125,522.945503852935
1534,803,24552,73,377,396,576,323,199,1044,64277,1.6231155778894473,379.38107491017524
1535,1228,24552,61,351,451,626,390,275,1330,107250,1.4181818181818182,477.20540650751224
1536,687,24552,47,348,451,533,404,185,1178,74740,2.183783783783784,444.3433357213766
1537,349,24552,173,384,396,529,223,145,736,32335,1.5379310344827586,265.9962405749375
1538,952,24552,166,389,413,494,247,105,704,25935,2.3523809523809525,268.3915050816624
1539,421,24552,227,340,405,529,178,189,734,33642,0.9417989417989416,259.6247291765559
1540,957,24552,68,363,420,634,352,271,1246,95392,1.2988929889298892,444.2352980122133
1541,1056,24552,60,341,495,652,435,311,1492,135285,1.3987138263665595,534.739188764018
1542,325,12275,42,326,103,361,61,35,192,2135,1.7428571428571429,70.32780389006896
1543,1599,12275,73,327,110,355,37,28,130,1036,1.3214285714285714,46.400431032480725
1544,66,12275,19,322,115,389,96,67,326,6432,1.4328358208955223,117.06835610018618
1545,993,12275,70,324,109,357,39,33,144,1287,1.181818181818182,51.088159097779204
1546,621,12275,18,326,116,390,98,64,324,6272,1.53125,117.04699910719626
1547,177,12275,26,317,106,373,80,56,272,4480,1.4285714285714286,97.65244492586962
1548,1219,12275,19,320,114,387,95,67,324,6365,1.417910447761194,116.2497311824849
1549,1469,12275,24,318,105,387,81,69,300,5589,1.173913043478261,106.4048871058092
1550,1087,5332,33,680,877,1226,844,546,2780,460824,1.5457875457875458,1005.2124153630416
1551,1212,5332,23,680,878,1235,855,555,2820,474525,1.5405405405405406,1019.3380204819205
1552,1357,5332,71,686,882,1225,811,539,2700,437129,1.5046382189239331,973.7771819055938
1553,1683,5332,140,709,784,1217,644,508,2304,327152,1.2677165354330708,820.2438661763952
1554,1748,5332,42,689,882,1199,840,510,2700,428400,1.6470588235294117,982.700361249552
1555,1745,5332,108,709,797,1116,689,407,2192,280423,1.692874692874693,800.2312165868062
1556,546,5332,23,673,889,1235,866,562,2856,486692,1.5409252669039146,1032.3759005323593
1557,1396,5332,202,686,860,1114,658,428,2172,281624,1.5373831775700937,784.9509538818334
1558,873,5332,31,680,851,1209,820,529,2698,433780,1.5500945179584118,975.8283660562446
1559,930,23444,82,432,425,683,343,251,1188,86093,1.3665338645418326,425.0294107470682
1560,998,23444,114,406,348,650,234,244,956,57096,0.9590163934426228,338.07099846038255
1561,879,23444,66,404,406,690,340,286,1252,97240,1.1888111888111887,444.292696316291
1562,242,25351,55,1185,356,1353,301,168,938,50568,1.7916666666666667,344.7100230628637
1563,952,25351,70,1193,260,1333,190,140,660,26600,1.3571428571428572,236.00847442411893
1564,941,25351,47,1175,387,1365,340,190,1060,64600,1.7894736842105263,389.48684188300894
1565,957,25351,44,1177,386,1364,342,187,1058,63954,1.8288770053475936,389.7858386344994
1566,639,25351,60,1187,271,1360,211,173,768,36503,1.2196531791907514,272.8552729928451
1567,189,25351,46,1176,385,1366,339,190,1058,64410,1.7842105263157897,388.6142045782681
1568,12,25351,47,1173,381,1365,334,192,1052,64128,1.7395833333333333,385.25316351718647
1569,1709,25351,45,1181,237,1363,192,182,748,34944,1.0549450549450552,264.55245226608656
1570,1554,25351,44,1175,385,1364,341,189,1060,64449,1.804232804232804,389.8743387298015
1571,560,29828,77,1138,132,1213,55,75,260,4125,0.7333333333333333,93.00537618869137
1572,1225,29828,78,1134,156,1201,78,67,290,5226,1.164179104477612,102.82509421342633
1573,841,29828,82,1125,140,1205,58,80,276,4640,0.725,98.812954616285
1574,1363,2276,43,784,122,906,79,122,402,9638,0.6475409836065574,145.34441853748632
1575,1103,2276,38,785,105,911,67,126,386,8442,0.5317460317460317,142.70599146496969
1576,1106,2276,40,786,101,909,61,123,368,7503,0.4959349593495935,137.2953021774598
1577,178,12851,93,817,270,901,177,84,522,14868,2.107142857142857,195.92090240706835
1578,1372,12851,61,805,261,934,200,129,658,25800,1.5503875968992251,237.9936973955403
1579,1705,12851,105,805,291,907,186,102,576,18972,1.8235294117647056,212.13203435596427
1580,1102,12851,118,807,289,961,171,154,650,26334,1.1103896103896105,230.1238796822268
1581,272,12851,87,778,289,924,202,146,696,29492,1.3835616438356164,249.23884127479008
1582,3,12851,109,814,269,895,160,81,482,12960,1.9753086419753083,179.3348822733603
1583,1721,17202,91,690,227,806,136,116,504,15776,1.1724137931034482,178.75122377203465
1584,413,17202,101,699,209,798,108,99,414,10692,1.0909090909090908,146.50938536489735
1585,1375,17202,68,695,205,808,137,113,500,15481,1.2123893805309736,177.5894140989265
1586,389,17735,176,903,237,993,61,90,302,5490,0.6777777777777778,108.72442227944924
1587,451,17735,84,897,257,980,173,83,512,14359,2.0843373493975905,191.88017094009479
1588,560,17735,104,880,257,1008,153,128,562,19584,1.1953125,199.4818287463798
1589,457,17735,81,893,261,978,180,85,530,15300,2.117647058823529,199.06029237394384
1590,674,17735,111,907,257,980,146,73,438,10658,2.0,163.23296235748464
1591,1697,17735,91,854,285,1003,194,149,686,28906,1.3020134228187918,244.6160256401857
1592,882,421,51,935,243,1064,192,129,642,24768,1.4883720930232558,231.3114783144148
1593,1472,421,55,938,239,1060,184,122,612,22448,1.5081967213114753,220.77137495608437
1594,1112,421,56,933,116,980,60,47,214,2820,1.2765957446808511,76.21679604916491
1595,60,421,70,942,237,1060,167,118,570,19706,1.4152542372881356,204.48227307030797
1596,1111,421,57,932,247,1064,190,132,644,25080,1.4393939393939394,231.35254483147577
1597,886,421,50,933,245,1060,195,127,644,24765,1.5354330708661417,232.71012010653942
1598,1058,21818,46,888,141,976,95,88,366,8360,1.0795454545454546,129.49517365523704
1599,1188,21818,77,891,190,979,113,88,402,9944,1.2840909090909092,143.22360140703069
1600,853,21818,67,895,133,966,66,71,274,4686,0.9295774647887324,96.93812459502195
1601,1182,21818,77,896,134,966,57,70,254,3990,0.8142857142857143,90.27181176868004
1602,1006,21818,60,886,127,985,67,99,332,6633,0.6767676767676768,119.54078801814885
1603,338,21818,171,882,194,956,23,74,194,1702,0.3108108108108108,77.4919350642375
1604,330,21818,80,874,229,990,149,116,530,17284,1.2844827586206895,188.83061192507955
1605,851,21818,60,882,198,980,138,98,472,13524,1.4081632653061225,169.2572007330855
1606,421,21818,71,890,144,933,73,43,232,3139,1.6976744186046508,84.72307831990054
1607,125,21818,44,890,133,975,89,85,348,7565,1.0470588235294118,123.0690862889621
1608,962,28007,37,599,256,775,219,176,790,38544,1.244318181818182,280.95729212818094
1609,1198,28007,51,560,263,774,212,214,852,45368,0.9906542056074766,301.2308085173228
1610,1206,28007,36,555,226,780,190,225,830,42750,0.8444444444444444,294.49108645254444
1611,44,28007,36,550,317,798,281,248,1058,69688,1.1330645161290325,374.78660595063957
1612,818,28007,41,551,299,799,258,248,1012,63984,1.0403225806451613,357.865896670806
1613,577,31791,285,698,595,1112,310,414,1448,128340,0.7487922705314008,517.2001546790178
1614,957,31791,262,696,623,1115,361,419,1560,151259,0.8615751789976134,553.0659996781577
1615,947,31791,318,699,573,1123,255,424,1358,108120,0.6014150943396226,494.7736856381916
1616,1061,11380,108,839,299,1115,191,276,934,52716,0.6920289855072463,335.6441568089634
1617,952,11380,121,939,212,992,91,53,288,4823,1.7169811320754718,105.30906893520614
1618,637,11380,99,787,368,1190,269,403,1344,108407,0.6674937965260546,484.5307007816945
1619,688,11380,179,959,295,1034,116,75,382,8700,1.5466666666666666,138.13399291991817
1620,1237,11380,105,794,346,1171,241,377,1236,90857,0.6392572944297082,447.4483210383072
1621,419,11380,99,815,347,1175,248,360,1216,89280,0.6888888888888889,437.154434954056
1622,14,11380,88,794,285,928,197,134,662,26398,1.4701492537313432,238.2540660723338
1623,1130,11380,67,787,436,1195,369,408,1554,150552,0.9044117647058824,550.1136246267674
1624,421,11380,80,780,367,1182,287,402,1378,115374,0.7139303482587065,493.93623070189943
1625,1661,11380,75,822,369,1175,294,353,1294,103782,0.8328611898016998,459.396343041605
1626,126,11380,99,805,380,1086,281,281,1124,78961,1.0,397.39401102683973
1627,957,24587,50,702,149,732,99,30,258,2970,3.3,103.4456378974
1628,242,24587,33,681,255,773,222,92,628,20424,2.4130434782608696,240.30813552603666
1629,687,24587,31,698,251,735,220,37,514,8140,5.945945945945946,223.0896680709351
1630,349,24587,50,691,254,755,204,64,536,13056,3.1875,213.80364823828427
1631,952,24587,55,704,229,737,174,33,414,5742,5.2727272727272725,177.1016657177453
1632,1228,24587,49,680,246,764,197,84,562,16548,2.345238095238096,214.1611542740653
1633,803,24587,48,674,243,761,195,87,564,16965,2.2413793103448274,213.52751579129094
1634,132,24587,48,682,187,743,139,61,400,8479,2.278688524590164,151.79591562357663
1635,678,21720,46,567,118,635,72,68,280,4896,1.0588235294117647,99.03534722511958
1636,0,21720,36,575,92,649,56,74,260,4144,0.7567567567567568,92.80086206496145
1637,1173,21720,54,596,79,620,25,24,98,600,1.0416666666666667,34.655446902326915
1638,729,21720,32,569,112,654,80,85,330,6800,0.9411764705882352,116.72617529928752
1639,58,21720,47,572,106,638,59,66,250,3894,0.8939393939393939,88.52683209061533
1640,1508,23078,101,412,374,676,273,264,1074,72072,1.0340909090909092,379.7696670351649
1641,1500,23078,130,413,382,677,252,264,1032,66528,0.9545454545454546,364.9657518178932
1642,247,23078,146,409,374,673,228,264,984,60192,0.8636363636363636,348.82660448996717
1643,1241,23078,160,446,332,661,172,215,774,36980,0.8,275.3343422096125
1644,971,23078,138,417,378,655,240,238,956,57120,1.0084033613445378,338.0
1645,1154,2381,11,253,606,1118,595,865,2920,514675,0.6878612716763006,1049.880945631456
1646,105,2381,29,265,639,1161,610,896,3012,546560,0.6808035714285714,1083.9354224306908
1647,601,2381,57,262,520,962,463,700,2326,324100,0.6614285714285715,839.2669420393014
1648,314,29285,77,916,110,933,33,17,100,561,1.9411764705882355,37.12142238654117
1649,379,29285,76,917,110,932,34,15,98,510,2.2666666666666666,37.16180835212409
1650,1585,29285,78,917,114,931,36,14,100,504,2.571428571428572,38.62641583165593
1651,705,29285,79,912,112,936,33,24,114,792,1.375,40.80441152620633
1652,1736,29285,64,910,117,938,53,28,162,1484,1.8928571428571428,59.941638282582836
1653,105,29285,78,916,113,938,35,22,114,770,1.5909090909090908,41.340053217188775
1654,719,29285,91,922,95,931,4,9,26,36,0.4444444444444444,9.848857801796104
1655,1026,29285,75,916,114,934,39,18,114,702,2.1666666666666665,42.95346318982906
1656,831,29285,75,914,118,934,43,20,126,860,2.15,47.4236228055175
1657,869,29285,73,916,121,942,48,26,148,1248,1.8461538461538465,54.589376255824725
1658,1165,29285,73,914,113,941,40,27,134,1080,1.4814814814814814,48.25971404805462
1659,1480,20159,109,639,712,1172,603,533,2272,321399,1.131332082551595,804.796868781185
1660,506,20159,38,645,716,1210,678,565,2486,383070,1.2,882.5582133774519
1661,329,20159,52,612,677,1158,625,546,2342,341250,1.1446886446886446,829.9042113400799
1662,276,20159,200,625,476,967,276,342,1236,94392,0.8070175438596491,439.4769618535197
1663,610,20159,190,645,536,871,346,226,1144,78196,1.5309734513274336,413.26988760373047
1664,1362,20159,244,730,605,1113,361,383,1488,138263,0.9425587467362924,526.317394734394
1665,1223,20159,38,633,710,1195,672,562,2468,377664,1.195729537366548,876.0296798625033
1666,362,30500,66,361,136,426,70,65,270,4550,1.0769230769230769,95.524865872714
1667,1573,30500,79,366,158,415,79,49,256,3871,1.6122448979591837,92.9623579735368
1668,140,30500,65,372,147,430,82,58,280,4756,1.4137931034482758,100.43903623591775
1669,1663,30500,78,368,166,420,88,52,280,4576,1.6923076923076923,102.2154587134451
1670,1498,30500,72,365,173,419,101,54,310,5454,1.8703703703703705,114.5294721894762
1671,45,30500,64,363,166,423,102,60,324,6120,1.7,118.33849753989612
1672,421,9951,73,346,859,858,786,512,2596,402432,1.53515625,938.0511713120985
1673,241,9951,27,223,825,857,798,634,2864,505932,1.2586750788643533,1019.1957613726619
1674,1653,9951,19,392,831,774,812,382,2388,310184,2.12565445026178,897.3672603789377
1675,502,7506,37,994,41,997,4,3,14,12,1.3333333333333333,5.0
1676,1698,7506,37,994,41,997,4,3,14,12,1.3333333333333333,5.0
1677,328,7506,38,994,41,997,3,3,12,9,1.0,4.242640687119285
1678,1036,7506,37,994,41,997,4,3,14,12,1.3333333333333333,5.0
1679,1045,7506,38,995,40,997,2,2,8,4,1.0,2.8284271247461903
1680,66,7506,37,994,41,997,4,3,14,12,1.3333333333333333,5.0
1681,1115,28577,110,687,394,962,284,275,1118,78100,1.0327272727272727,395.32391781929914
1682,1225,28577,106,791,405,927,299,136,870,40664,2.198529411764706,328.4767876121538
1683,1534,28577,107,801,379,962,272,161,866,43792,1.6894409937888202,316.07752213657966
1684,1105,28577,107,693,352,956,245,263,1016,64435,0.9315589353612168,359.43566879206634
1685,669,28577,123,693,410,950,287,257,1088,73759,1.1167315175097277,385.25056781268995
1686,932,28577,100,791,389,956,289,165,908,47685,1.7515151515151517,332.78521601777925
1687,924,28577,168,700,311,955,143,255,796,36465,0.5607843137254902,292.35936790190254
1688,1367,28577,124,695,249,799,125,104,458,13000,1.2019230769230769,162.60688792299052
1689,1319,28577,133,705,346,941,213,236,898,50268,0.9025423728813561,317.90721916936707
1690,251,24173,78,476,649,881,571,405,1952,231255,1.4098765432098763,700.0471412697862
1691,963,24173,229,551,464,764,235,213,896,50055,1.1032863849765258,317.1655719021218
1692,971,24173,184,486,592,828,408,342,1500,139536,1.1929824561403508,532.379563845195
1693,1343,24173,202,478,498,779,296,301,1194,89096,0.9833887043189368,422.15755352711625
1694,1383,24173,218,483,498,770,280,287,1134,80360,0.975609756097561,400.96009776535124
1695,1555,24173,166,517,506,874,340,357,1394,121380,0.9523809523809524,493.0
1696,592,24173,146,482,536,829,390,347,1474,135330,1.1239193083573489,522.0239458109178
1697,530,24173,239,490,515,788,276,298,1148,82248,0.9261744966442952,406.1773011875479
1698,527,24173,201,550,572,758,371,208,1158,77168,1.7836538461538465,425.3292842022519
1699,389,17717,173,234,415,561,242,327,1138,79134,0.7400611620795107,406.80830866637916
1700,457,17717,67,228,423,572,356,344,1400,122464,1.0348837209302326,495.04747247107525
1701,451,17717,172,267,406,537,234,270,1008,63180,0.8666666666666667,357.2897983430257
1702,560,17717,162,279,346,493,184,214,796,39376,0.8598130841121495,282.2268591045154
1703,674,17717,155,242,362,543,207,301,1016,62307,0.6877076411960132,365.3080891521566
1704,167,17717,141,236,422,567,281,331,1224,93011,0.8489425981873112,434.1912021218302
1705,1588,9628,37,636,141,733,104,97,402,10088,1.0721649484536082,142.21462653327893
1706,1511,9628,41,637,206,751,165,114,558,18810,1.4473684210526316,200.55173896029922
1707,1210,9628,37,635,212,741,175,106,562,18550,1.650943396226415,204.59960899278374
1708,70,20605,40,701,86,724,46,23,138,1058,2.0,51.42956348249516
1709,898,20605,42,692,85,727,43,35,156,1505,1.2285714285714286,55.44366510251645
1710,1182,20605,46,701,84,728,38,27,130,1026,1.4074074074074074,46.61544808322666
1711,1685,8189,102,1478,145,1557,43,79,244,3397,0.5443037974683544,89.94442728707543
1712,265,8189,83,1471,155,1566,72,95,334,6840,0.7578947368421053,119.20151005754919
1713,448,8189,88,1488,147,1556,59,68,254,4012,0.8676470588235294,90.02777349240623
1714,213,8189,101,1471,147,1546,46,75,242,3450,0.6133333333333333,87.98295289429652
1715,1686,8189,96,1473,142,1549,46,76,244,3496,0.6052631578947368,88.83692925805124
1716,1031,8189,95,1471,148,1557,53,86,278,4558,0.6162790697674418,101.01980003939822
1717,47,8189,91,1475,147,1563,56,88,288,4928,0.6363636363636364,104.30723848324239
1718,154,8189,96,1481,147,1542,51,61,224,3111,0.8360655737704918,79.51100552753688
1719,188,28208,17,354,334,566,317,212,1058,67204,1.4952830188679245,381.35678832295616
1720,1187,28208,44,365,324,557,280,192,944,53760,1.4583333333333333,339.5055227827671
1721,337,28208,31,364,327,556,296,192,976,56832,1.5416666666666667,352.8172331391991
1722,115,26896,49,720,740,1309,691,589,2560,406999,1.1731748726655349,907.9658583889594
1723,1311,26896,236,777,824,1247,588,470,2116,276360,1.251063829787234,752.7575971054692
1724,1268,26896,158,730,937,1273,779,543,2644,422997,1.4346224677716393,949.5735885122332
1725,1684,1003,93,620,285,771,192,151,686,28992,1.271523178807947,244.2642012248213
1726,310,1003,48,607,288,751,240,144,768,34560,1.6666666666666667,279.8856909525744
1727,1694,1003,166,615,269,741,103,126,458,12978,0.8174603174603174,162.74212730574712
1728,555,1003,108,613,289,766,181,153,668,27693,1.1830065359477124,237.00210969525145
1729,607,1003,112,624,314,791,202,167,738,33734,1.2095808383233533,262.0934947685654
1730,1585,1003,155,616,275,729,120,113,466,13560,1.0619469026548674,164.83021567661677
1731,984,1003,95,603,280,741,185,138,646,25530,1.3405797101449275,230.8007798946962
1732,3,10864,42,930,456,1230,414,300,1428,124200,1.38,511.26900942654447
1733,387,10864,110,924,453,1228,343,304,1294,104272,1.1282894736842106,458.3284848228397
1734,1600,10864,87,933,437,1169,350,236,1172,82600,1.4830508474576272,422.13268056382464
1735,311,8799,67,884,357,1190,290,306,1192,88740,0.9477124183006536,421.5874760948195
1736,866,8799,45,873,364,1192,319,319,1276,101761,1.0,451.1341263970173
1737,448,8799,75,891,323,1178,248,287,1070,71176,0.8641114982578397,379.30594511554915
1738,470,27242,89,800,398,1120,309,320,1258,98880,0.965625,444.8381728224321
1739,853,27242,72,819,467,1107,395,288,1366,113760,1.3715277777777777,488.84455607074113
1740,338,27242,44,797,482,1130,438,333,1542,145854,1.3153153153153154,550.2117774093899
1741,468,27242,48,783,510,1167,462,384,1692,177408,1.203125,600.7495318350236
1742,421,27242,60,785,346,1010,286,225,1022,64350,1.2711111111111109,363.8969634388284
1743,941,27242,36,782,524,1186,488,404,1784,197152,1.207920792079208,633.5297940902227
1744,191,27242,107,789,409,1132,302,343,1290,103586,0.8804664723032071,457.00437634666037
1745,952,27242,76,787,337,833,261,46,614,12006,5.673913043478262,265.02264054227516
1746,1420,35660,100,256,470,575,370,319,1378,118030,1.1598746081504705,488.5294259305165
1747,191,35660,114,301,356,509,242,208,900,50336,1.1634615384615383,319.10499839394555
1748,891,35660,13,249,518,583,505,334,1678,168670,1.5119760479041915,605.4593297654269
1749,1435,35660,102,274,433,572,331,298,1258,98638,1.1107382550335572,445.3818586336898
1750,895,35660,41,269,458,582,417,313,1460,130521,1.3322683706070289,521.4000383582649
1751,131,35660,109,250,271,475,162,225,774,36450,0.72,277.2525924134885
1752,631,35660,82,261,469,582,387,321,1416,124227,1.2056074766355143,502.80214796677234
1753,952,35660,143,288,369,536,226,248,948,56048,0.9112903225806452,335.5294323900662
1754,1652,21169,86,503,255,650,169,147,632,24843,1.1496598639455782,223.98660674245681
1755,850,21169,102,498,295,658,193,160,706,30880,1.20625,250.69702830308938
1756,1721,21169,102,513,263,613,161,100,522,16100,1.61,189.52836199366047
1757,774,18573,73,717,269,893,196,176,744,34496,1.1136363636363635,263.4236132164313
1758,606,18573,193,744,263,845,70,101,342,7070,0.6930693069306929,122.88612614937456
1759,824,18573,109,768,269,783,160,15,350,2400,10.666666666666666,160.70158679988197
1760,1033,18573,178,709,271,821,93,112,410,10416,0.8303571428571429,145.57815770231468
1761,317,18573,290,721,291,722,1,1,4,1,1.0,1.4142135623730951
1762,941,27230,212,132,528,384,316,252,1136,79632,1.2539682539682542,404.1781785302121
1763,468,27230,226,137,921,835,695,698,2786,485110,0.995702005730659,985.0020304547601
1764,952,27230,268,164,434,320,166,156,644,25896,1.064102564102564,227.7981562699751
1765,1011,27230,167,167,447,337,280,170,900,47600,1.6470588235294117,327.566787083184
1766,421,27230,366,723,610,845,244,122,732,29768,2.0,272.80029325497435
1767,470,27230,429,681,679,821,250,140,780,35000,1.7857142857142858,286.53097563788805
1768,853,27230,243,145,480,325,237,180,834,42660,1.3166666666666669,297.6054434986027
1769,854,27230,167,225,942,823,775,598,2746,463450,1.2959866220735785,978.8917202632781
1770,1182,13156,50,407,375,572,325,165,980,53625,1.9696969696969695,364.4859393721519
1771,1537,13156,55,362,393,569,338,207,1090,69966,1.6328502415458936,396.3495931624
1772,804,13156,21,356,400,585,379,229,1216,86791,1.6550218340611351,442.8114722994426
1773,592,20465,40,641,433,912,393,271,1328,106503,1.4501845018450183,477.3782567314938
1774,1145,20465,35,647,428,909,393,262,1310,102966,1.5,472.3272170857826
1775,426,20465,38,690,430,867,392,177,1138,69384,2.214689265536723,430.108125940443
1776,857,15749,371,542,615,788,244,246,980,60024,0.9918699186991871,346.48520891951506
1777,755,15749,363,557,596,790,233,233,932,54289,1.0,329.51176003293114
1778,909,15749,307,562,574,833,267,271,1076,72357,0.985239852398524,380.4339627320358
1779,809,15749,181,486,701,950,520,464,1968,241280,1.1206896551724137,696.9189335927099
1780,965,15749,387,549,598,733,211,184,790,38824,1.1467391304347827,279.95892555873263
1781,203,15749,282,542,688,850,406,308,1428,125048,1.318181818181818,509.6076922496363
1782,88,15749,359,542,619,815,260,273,1066,70980,0.9523809523809524,377.0
1783,651,15749,343,572,618,832,275,260,1070,71500,1.0576923076923077,378.4507894033252
1784,1452,15749,371,464,651,825,280,361,1282,101080,0.775623268698061,456.8599347721356
1785,1351,215,245,663,824,1027,579,364,1886,210756,1.5906593406593406,683.9130061637957
1786,718,215,306,678,824,986,518,308,1652,159544,1.681818181818182,602.6508110008648
1787,1243,215,228,639,828,1038,600,399,1998,239400,1.5037593984962403,720.5560352949658
1788,886,30777,114,1241,202,1333,88,92,360,8096,0.9565217391304348,127.31064370271639
1789,936,30777,170,1210,215,1243,45,33,156,1485,1.3636363636363635,55.80322571321482
1790,568,30777,114,1229,291,1426,177,197,748,34869,0.8984771573604061,264.83579818446
1791,922,30777,139,1245,253,1392,114,147,522,16758,0.7755102040816326,186.02419197512995
1792,1706,30777,121,1224,313,1424,192,200,784,38400,0.96,277.2435752186153
1793,391,30777,130,1240,202,1294,72,54,252,3888,1.3333333333333333,90.0
1794,230,30777,111,1249,267,1377,156,128,568,19968,1.21875,201.79197209007103
1795,1514,14178,76,806,150,871,74,65,278,4810,1.1384615384615384,98.49365461794989
1796,1580,14178,38,752,238,865,200,113,626,22600,1.7699115044247788,229.71504086585188
1797,1246,14178,36,752,240,888,204,136,680,27744,1.5,245.17748673155128
1798,1299,14178,69,814,171,871,102,57,318,5814,1.7894736842105263,116.84605256490268
1799,449,14178,82,784,154,864,72,80,304,5760,0.9,107.62899237658968
1800,1739,14178,47,756,236,883,189,127,632,24003,1.4881889763779528,227.705950734714
1801,1086,14178,90,798,139,876,49,78,254,3822,0.6282051282051282,92.11405973031478
1802,1462,14178,66,794,159,882,93,88,362,8184,1.056818181818182,128.03515142334936
1803,262,14178,67,786,171,876,104,90,388,9360,1.1555555555555554,137.53544997563355
1804,161,14178,41,763,211,880,170,117,574,19890,1.4529914529914532,206.37102509800158
1805,552,14178,65,764,177,886,112,122,468,13664,0.918032786885246,165.61400906928134
1806,53,27685,142,113,994,594,852,481,2666,409812,1.7713097713097714,978.3992027797243
1807,1580,27685,97,105,998,535,901,430,2662,387430,2.0953488372093023,998.3491373262161
1808,831,27685,106,167,828,550,722,383,2210,276526,1.8851174934725852,817.2961519547245
1809,662,27685,105,127,996,659,891,532,2846,474012,1.674812030075188,1037.740333609521
1810,1257,27685,150,173,932,577,782,404,2372,315928,1.935643564356436,880.193160618736
1811,1585,27685,164,125,984,539,820,414,2468,339480,1.9806763285024156,918.5836924309075
1812,1034,27685,146,120,990,518,844,398,2484,335912,2.120603015075377,933.1345026307837
1813,1751,27685,220,232,495,518,275,286,1122,78650,0.9615384615384616,396.76315353117155
1814,656,35307,17,316,223,610,206,294,1000,60564,0.7006802721088435,358.98746496221844
1815,164,35307,23,325,207,604,184,279,926,51336,0.6594982078853047,334.2110111890391
1816,1694,35307,22,321,296,542,274,221,990,60554,1.239819004524887,352.0184654247558
1817,504,28694,131,427,521,690,390,263,1306,102570,1.4828897338403042,470.3923893942163
1818,1225,28694,90,403,600,765,510,362,1744,184620,1.4088397790055247,625.4150621787103
1819,993,28694,172,462,452,724,280,262,1084,73360,1.068702290076336,383.46316641888825
1820,1023,179,116,515,330,723,214,208,844,44512,1.0288461538461535,298.4292210893565
1821,1383,179,127,490,321,733,194,243,874,47142,0.7983539094650206,310.94211679989576
1822,1508,179,135,532,316,731,181,199,760,36019,0.9095477386934674,269.0018587296378
1823,1107,3357,53,695,79,723,26,28,108,728,0.9285714285714286,38.2099463490856
1824,840,3357,33,690,80,725,47,35,164,1645,1.3428571428571427,58.60034129593445
1825,1116,3357,47,689,81,724,34,35,138,1190,0.9714285714285714,48.79549159502341
1826,382,1534,242,558,608,952,366,394,1520,144204,0.9289340101522844,537.7657482584773
1827,1749,1534,181,555,620,934,439,379,1636,166381,1.158311345646438,579.9672404541484
1828,1360,1534,180,519,634,960,454,441,1790,200214,1.0294784580498866,632.9273260019668
1829,777,1534,274,628,387,788,113,160,546,18080,0.70625,195.88006534611938
1830,831,1534,153,534,696,971,543,437,1960,237291,1.242562929061785,697.0064562111315
1831,1098,1534,227,621,540,942,313,321,1268,100473,0.9750778816199376,448.34138778390735
1832,919,20798,95,1075,389,1464,294,389,1366,114366,0.7557840616966581,487.6033223840871
1833,1521,20798,85,1081,389,1491,304,410,1428,124640,0.7414634146341463,510.4076801930002
1834,1156,20798,99,1117,376,1448,277,331,1216,91687,0.8368580060422961,431.6132528085763
1835,577,31808,189,258,746,783,557,525,2164,292425,1.0609523809523809,765.4240654695932
1836,957,31808,187,225,837,785,650,560,2420,364000,1.1607142857142858,857.962703152066
1837,1127,31808,263,472,489,772,226,300,1052,67800,0.7533333333333333,375.6008519692148
1838,335,31808,102,427,706,740,604,313,1834,189052,1.9297124600638975,680.2830293341148
1839,947,31808,142,237,735,776,593,539,2264,319627,1.1001855287569573,801.3551023110791
1840,1700,24919,43,669,341,886,298,217,1030,64666,1.3732718894009217,368.6366775023885
1841,119,24919,62,720,183,825,121,105,452,12705,1.1523809523809525,160.20611723651504
1842,501,24919,39,661,355,878,316,217,1066,68572,1.456221198156682,383.3340579703296
1843,833,24919,47,664,321,892,274,228,1004,62472,1.2017543859649122,356.4547657136877
1844,1594,24919,62,670,330,877,268,207,950,55476,1.2946859903381642,338.6340207362515
1845,788,24919,49,669,347,882,298,213,1022,63474,1.3990610328638498,366.2963281279243
1846,693,21545,312,562,322,596,10,34,88,340,0.29411764705882354,35.4400902933387
1847,431,21545,314,573,861,994,547,421,1936,230287,1.299287410926366,690.253576593414
1848,592,21545,234,562,771,999,537,437,1948,234669,1.22883295194508,692.3424008393534
1849,966,21545,324,593,670,921,346,328,1348,113488,1.054878048780488,476.7598976424087
1850,805,21545,298,572,715,839,417,267,1368,111339,1.5617977528089888,495.1545213365218
1851,552,14152,31,506,225,780,194,274,936,53156,0.708029197080292,335.72607882021913
1852,1462,14152,30,516,183,678,153,162,630,24786,0.9444444444444444,222.82953125651906
1853,449,14152,44,508,560,770,516,262,1556,135192,1.9694656488549616,578.7054518492115
1854,1086,14152,63,512,576,637,513,125,1276,64125,4.104,528.0094696120516
1855,1299,14152,459,531,580,664,121,133,508,16093,0.9097744360902256,179.8054504179448
1856,161,14152,25,490,241,828,216,338,1108,73008,0.6390532544378699,401.1234224026316
1857,1514,14152,553,521,563,542,10,21,62,210,0.4761904761904762,23.259406699226016
1858,1591,14152,29,515,586,806,557,291,1696,162087,1.9140893470790377,628.4345630214812
1859,1211,14152,57,520,244,833,187,313,1000,58531,0.597444089456869,364.6066373504465
1860,379,19649,49,854,65,869,16,15,62,240,1.0666666666666669,21.93171219946131
1861,711,19649,54,858,60,866,6,8,28,48,0.75,10.0
1862,1516,19649,49,853,65,870,16,17,66,272,0.9411764705882352,23.345235059857504
1863,1212,19649,51,856,62,867,11,11,44,121,1.0,15.556349186104045
1864,1559,20836,33,953,278,1265,245,312,1114,76440,0.7852564102564102,396.6976178400874
1865,1557,20836,55,952,283,1255,228,303,1062,69084,0.7524752475247525,379.2004746832472
1866,592,20836,111,969,274,1208,163,239,804,38957,0.6820083682008368,289.29223978530774
1867,586,14821,99,183,499,595,400,412,1624,164800,0.9708737864077671,574.2334020239506
1868,1508,14821,30,181,525,600,495,419,1828,207405,1.181384248210024,648.5260210662329
1869,1076,14821,71,202,551,560,480,358,1676,171840,1.340782122905028,598.802137604735
1870,656,32323,98,750,309,948,211,198,818,41778,1.0656565656565655,289.35272592460575
1871,161,32323,88,746,319,938,231,192,846,44352,1.203125,300.3747659175118
1872,107,32323,110,751,323,945,213,194,814,41322,1.097938144329897,288.1058833137567
1873,1181,8950,235,379,893,771,658,392,2100,257936,1.6785714285714286,765.9164445290361
1874,941,8950,124,358,295,807,171,449,1240,76779,0.38084632516703787,480.46019606206715
1875,525,8950,195,276,877,852,682,576,2516,392832,1.1840277777777777,892.6925562588724
1876,71,8950,295,320,923,835,628,515,2286,323420,1.2194174757281553,812.1631609473554
1877,753,8950,535,359,830,695,295,336,1262,99120,0.8779761904761905,447.125262091061
1878,1547,8950,248,333,927,829,679,496,2350,336784,1.3689516129032258,840.866814662108
1879,748,8950,379,423,826,662,447,239,1372,106833,1.8702928870292888,506.88262941237195
1880,183,8950,214,241,891,914,677,673,2700,455621,1.0059435364041605,954.5983448550495
1881,29,8950,463,349,868,724,405,375,1560,151875,1.08,551.9510847892229
1882,140,30498,25,445,254,550,229,105,668,24045,2.1809523809523808,251.92459189209774
1883,591,30498,21,468,81,523,60,55,230,3300,1.0909090909090908,81.39410298049853
1884,38,30498,39,454,258,558,219,104,646,22776,2.105769230769231,242.4396832203837
1885,1448,30498,22,430,258,559,236,129,730,30444,1.8294573643410847,268.9553866350328
1886,1663,30498,21,473,88,514,67,41,216,2747,1.6341463414634143,78.54934754662193
1887,1573,30498,28,468,82,511,54,43,194,2322,1.255813953488372,69.02897942168927
1888,651,30498,118,451,184,467,66,16,164,1056,4.125,67.91170738539859
1889,1498,30498,27,418,260,570,233,152,770,35416,1.5328947368421053,278.19597409020855
1890,1286,30498,41,436,239,563,198,127,650,25146,1.559055118110236,235.22967499871268
1891,45,30498,205,457,259,518,54,61,230,3294,0.8852459016393442,81.46778504415104
1892,242,25513,99,775,179,869,80,94,348,7520,0.851063829787234,123.43419299367578
1893,15,25513,59,774,167,872,108,98,412,10584,1.1020408163265305,145.83552379307312
1894,189,25513,30,753,196,884,166,131,594,21746,1.267175572519084,211.463944917331
1895,1121,25513,57,762,206,880,149,118,534,17582,1.2627118644067796,190.06577808748213
1896,1554,25513,68,755,219,877,151,122,546,18422,1.2377049180327868,194.12624758130983
1897,679,25513,134,773,166,816,32,43,150,1376,0.7441860465116279,53.600373133029585
1898,941,25513,113,769,168,869,55,100,310,5500,0.55,114.12712210513327
1899,1000,25513,62,771,170,875,108,104,424,11232,1.0384615384615383,149.9333185119305
1900,12,25513,52,771,178,878,126,107,466,13482,1.1775700934579438,165.3027525481654
1901,1733,14033,28,366,167,516,139,150,578,20850,0.9266666666666666,204.50183373260984
1902,1389,14033,28,363,173,513,145,150,590,21750,0.9666666666666668,208.62646045025065
1903,1241,14033,28,380,185,570,157,190,694,29830,0.8263157894736842,246.4731222669117
1904,374,18535,295,751,611,1191,316,440,1512,139040,0.7181818181818181,541.7157926440764
1905,161,18535,195,722,656,1206,461,484,1890,223124,0.9524793388429752,668.4137939929127
1906,1304,18535,189,759,706,1206,517,447,1928,231099,1.1565995525727069,683.4456818211671
1907,715,6668,72,913,388,1171,316,258,1148,81528,1.2248062015503876,407.9460748677452
1908,1360,6668,46,863,403,1193,357,330,1374,117810,1.0818181818181818,486.15738192482485
1909,1216,6668,106,890,405,1181,299,291,1180,87009,1.0274914089347078,417.23135069167563
1910,875,6668,78,882,352,1186,274,304,1156,83296,0.9013157894736842,409.25786492137206
1911,162,6668,171,881,401,1200,230,319,1098,73370,0.7210031347962382,393.269627609354
1912,575,2476,141,152,604,523,463,371,1668,171773,1.247978436657682,593.3043064060803
1913,892,2476,316,328,631,601,315,273,1176,85995,1.1538461538461535,416.8380980668634
1914,950,2476,37,203,641,598,604,395,1998,238580,1.5291139240506328,721.6931480899622
1915,1651,2476,69,163,600,568,531,405,1872,215055,1.3111111111111111,667.8218325272093
1916,572,2476,138,142,602,535,464,393,1714,182352,1.1806615776081424,608.0666081935432
1917,577,2476,79,133,749,615,670,482,2304,322940,1.3900414937759336,825.3629504648243
1918,140,27003,75,630,414,849,339,219,1116,74241,1.547945205479452,403.58642197180023
1919,1663,27003,29,626,439,878,410,252,1324,103320,1.6269841269841268,481.25253246086925
1920,1448,27003,42,595,394,878,352,283,1270,99616,1.2438162544169609,451.6558424287236
1921,809,9539,32,866,367,1133,335,267,1204,89445,1.2546816479400749,428.38534055217156
1922,909,9539,66,874,338,1136,272,262,1068,71264,1.0381679389312977,377.6612238501591
1923,1242,9539,47,868,381,1134,334,266,1200,88844,1.2556390977443608,426.9800932127867
1924,1698,26394,179,405,393,663,214,258,944,55212,0.8294573643410853,335.2014319778482
1925,1311,26394,389,430,390,431,1,1,4,1,1.0,1.4142135623730951
1926,1268,26394,28,399,388,671,360,272,1264,97920,1.3235294117647058,451.2028368705144
1927,1643,26394,56,408,388,628,332,220,1104,73040,1.509090909090909,398.2762860126121
1928,387,26394,28,412,389,686,361,274,1270,98914,1.3175182481751824,453.2074580145389
1929,1116,26394,158,406,400,657,242,251,986,60742,0.9641434262948207,348.66172717979816
1930,204,4099,114,848,398,1097,284,249,1066,70716,1.1405622489959841,377.69961609723674
1931,972,4099,65,851,375,1108,310,257,1134,79670,1.206225680933852,402.67729014683704
1932,1342,4099,50,855,398,1113,348,258,1212,89784,1.3488372093023255,433.20664814843275
1933,421,24260,82,825,147,879,65,54,238,3510,1.2037037037037035,84.50443775329198
1934,1238,24260,73,817,152,877,79,60,278,4740,1.3166666666666669,99.20181449953424
1935,957,24260,82,812,156,885,74,73,294,5402,1.0136986301369864,103.9471019317037
1936,1503,27338,63,978,686,1413,623,435,2116,271005,1.4321839080459768,759.8381406589169
1937,1442,27338,110,949,792,1356,682,407,2178,277574,1.6756756756756757,794.2121882721267
1938,818,27338,46,928,781,1402,735,474,2418,348390,1.5506329113924051,874.58618786258
1939,252,27338,54,967,790,1334,736,367,2206,270112,2.0054495912806543,822.4262884903425
1940,1206,27338,222,946,753,1284,531,338,1738,179478,1.5710059171597632,629.4481710196638
1941,364,27338,202,930,514,1257,312,327,1278,102024,0.9541284403669724,451.9657066636804
1942,485,27338,49,939,793,1454,744,515,2518,383160,1.4446601941747572,904.854131890881
1943,39,27338,40,927,799,1472,759,545,2608,413655,1.3926605504587155,934.401412670165
1944,1198,27338,120,972,797,1252,677,280,1914,189560,2.4178571428571427,732.6179085990186
1945,1479,7838,69,254,414,804,345,550,1790,189750,0.6272727272727273,649.2495668077107
1946,387,7838,102,249,345,839,243,590,1666,143370,0.411864406779661,638.0822830952134
1947,401,7838,72,318,403,472,331,154,970,50974,2.1493506493506493,365.0712259272155
1948,610,7838,109,285,442,852,333,567,1800,188811,0.5873015873015873,657.5545604738819
1949,1698,7838,98,317,349,802,251,485,1472,121735,0.5175257731958763,546.1007233102699
1950,1319,7838,107,289,344,855,237,566,1606,134142,0.4187279151943463,613.616329639295
1951,996,7838,266,360,274,505,8,145,306,1160,0.05517241379310345,145.2205219657332
1952,115,28516,170,164,705,690,535,526,2122,281410,1.0171102661596958,750.2672857055677
1953,1603,28516,169,162,718,691,549,529,2156,290421,1.0378071833648392,762.3922874741061
1954,1225,28516,163,182,676,691,513,509,2044,261117,1.0078585461689586,722.6686654338903
1955,1087,5383,38,632,173,725,135,93,456,12555,1.4516129032258065,163.93291310777101
1956,873,5383,41,636,117,723,76,87,326,6612,0.8735632183908046,115.52056094046635
1957,1745,5383,123,665,142,714,19,49,136,931,0.3877551020408163,52.55473337388365
1958,827,5383,48,635,97,711,49,76,250,3724,0.6447368421052632,90.4267659490264
1959,1357,5383,38,639,170,721,132,82,428,10824,1.6097560975609757,155.3962676514465
1960,1396,5383,48,639,172,719,124,80,408,9920,1.55,147.56693396557372
1961,313,5383,32,638,176,723,144,85,458,12240,1.6941176470588235,167.2154299100415
1962,1086,5383,34,645,106,660,72,15,174,1080,4.8,73.54590403278758
1963,546,5383,37,641,171,724,134,83,434,11122,1.6144578313253013,157.62296786953354
1964,1683,5383,40,642,164,716,124,74,396,9176,1.6756756756756757,144.40221604947757
1965,1186,34958,248,201,684,640,436,439,1750,191404,0.9931662870159452,618.7220700767025
1966,1422,34958,190,245,670,673,480,428,1816,205440,1.1214953271028036,643.1049681039635
1967,1546,34958,312,221,670,552,358,331,1378,118498,1.081570996978852,487.5705077217038
1968,1377,34958,376,248,636,510,260,262,1044,68120,0.9923664122137404,369.1124489908191
1969,1332,34958,316,237,593,512,277,275,1104,76175,1.007272727272727,390.3255051876574
1970,191,34958,343,264,576,507,233,243,952,56619,0.9588477366255144,336.6570955735227
1971,1712,34958,333,286,545,511,212,225,874,47700,0.9422222222222222,309.142362027594
1972,1236,34958,447,281,558,477,111,196,614,21756,0.5663265306122449,225.24875138388668
1973,1390,33736,39,838,228,956,189,118,614,22302,1.6016949152542372,222.81157959136684
1974,759,33736,42,843,219,946,177,103,560,18231,1.7184466019417477,204.78769494283586
1975,648,33736,43,837,221,940,178,103,562,18334,1.7281553398058251,205.65261972559455
1976,514,9842,49,394,521,1005,472,611,2166,288392,0.7725040916530278,772.0783638983804
1977,886,9842,10,355,530,1014,520,659,2358,342680,0.7890743550834598,839.452797958289
1978,66,9842,25,431,496,967,471,536,2014,252456,0.878731343283582,713.5383661724154
1979,1599,9842,20,411,547,1011,527,600,2254,316200,0.8783333333333333,798.5793636201727
1980,1389,7418,35,600,129,670,94,70,328,6580,1.3428571428571427,117.2006825918689
1981,1617,7418,42,600,123,669,81,69,300,5589,1.173913043478261,106.4048871058092
1982,1349,7418,32,598,141,671,109,73,364,7957,1.4931506849315068,131.18688958886096
1983,972,4195,133,1257,212,1444,79,187,532,14773,0.4224598930481284,203.00246303924493
1984,1508,4195,102,1291,250,1440,148,149,594,22052,0.9932885906040269,210.01190442448734
1985,1499,4195,448,1159,546,1254,98,95,386,9310,1.0315789473684212,136.48809471891678
1986,1389,4195,71,1257,285,1490,214,233,894,49862,0.9184549356223176,316.36213427020624
1987,526,4195,88,1233,331,1479,243,246,978,59778,0.9878048780487804,345.7817230566127
1988,480,4195,422,1146,531,1269,109,123,464,13407,0.8861788617886179,164.34719346554112
1989,1024,4195,136,1276,287,1454,151,178,658,26878,0.8483146067415731,233.42022191746798
1990,1506,4195,97,1086,677,1481,580,395,1950,229100,1.4683544303797469,701.7300050589258
1991,1562,4195,88,1263,295,1466,207,203,820,42021,1.019704433497537,289.9275771636772
1992,854,1202,156,771,279,901,123,130,506,15990,0.946153846153846,178.96647730790255
1993,338,1202,124,788,235,869,111,81,384,8991,1.3703703703703705,137.41178988718545
1994,941,1202,154,755,275,900,121,145,532,17545,0.8344827586206897,188.85444130334875
1995,468,1202,135,755,275,899,140,144,568,20160,0.9722222222222222,200.83824337013107
1996,853,1202,153,769,276,898,123,129,504,15867,0.9534883720930232,178.24140933015536
1997,947,1202,154,776,276,901,122,125,494,15250,0.976,174.6682569902156
1998,240,1202,127,759,245,898,118,139,514,16402,0.8489208633093526,182.33211456021672
1999,235,1202,149,767,245,893,96,126,444,12096,0.7619047619047619,158.40454538932903
2000,854,20324,64,415,422,730,358,315,1346,112770,1.1365079365079365,476.85322689481717
2001,71,20324,58,404,445,742,387,338,1450,130806,1.1449704142011834,513.821953598715
2002,476,20324,66,415,471,724,405,309,1428,125145,1.3106796116504855,509.4173141933831
2003,523,20324,42,394,382,750,340,356,1392,121040,0.9550561797752808,492.2763451558484
2004,852,20324,30,409,434,745,404,336,1480,135744,1.2023809523809523,525.4636048291071
2005,709,35021,47,443,120,493,73,50,246,3650,1.46,88.48163651289458
2006,1250,35021,36,438,121,494,85,56,282,4760,1.5178571428571428,101.78899744078434
2007,656,35021,42,439,116,494,74,55,258,4070,1.3454545454545457,92.20086767487604
2008,891,19276,27,556,234,759,207,203,820,42021,1.019704433497537,289.9275771636772
2009,1610,19276,56,569,196,754,140,185,650,25900,0.7567567567567568,232.0021551624036
2010,1185,19276,27,556,218,748,191,192,766,36672,0.9947916666666666,270.8228203087768
2011,367,18781,62,915,179,994,117,79,392,9243,1.4810126582278482,141.1736519326464
2012,1021,18781,49,851,292,1013,243,162,810,39366,1.5,292.04965331258313
2013,1728,18781,70,869,302,1002,232,133,730,30856,1.7443609022556392,267.41914665932205
2014,297,18781,83,859,295,1002,212,143,710,30316,1.4825174825174825,255.72055060162842
2015,699,18781,70,930,245,982,175,52,454,9100,3.3653846153846154,182.56231812726304
2016,362,18781,74,930,174,988,100,58,316,5800,1.7241379310344829,115.6027681329474
2017,855,18781,313,880,314,881,1,1,4,1,1.0,1.4142135623730951
2018,868,19608,27,330,615,755,588,425,2026,249900,1.3835294117647061,725.512922007596
2019,379,19608,86,384,594,729,508,345,1706,175260,1.4724637681159418,614.075728229019
2020,1248,19608,40,396,599,731,559,335,1788,187265,1.6686567164179105,651.6947138039405
2021,1210,19608,100,371,593,712,493,341,1668,168113,1.4457478005865103,599.4414066445527
2022,380,19608,74,384,572,717,498,333,1662,165834,1.4954954954954955,599.0767897356732
2023,1075,17064,51,616,92,663,41,47,176,1927,0.8723404255319149,62.369864518050704
2024,648,17064,37,604,92,661,55,57,224,3135,0.9649122807017544,79.20858539325141
2025,1194,17064,35,607,93,663,58,56,228,3248,1.0357142857142858,80.62257748298549
2026,909,17064,53,612,90,653,37,41,156,1517,0.902439024390244,55.226805085936306
2027,434,17064,53,605,88,657,35,52,174,1820,0.6730769230769231,62.68173577685928
2028,1106,2513,35,527,137,597,102,70,344,7140,1.457142857142857,123.70933675353692
2029,455,2513,35,523,150,594,115,71,372,8165,1.6197183098591552,135.15176654413364
2030,793,2513,39,529,143,591,104,62,332,6448,1.6774193548387095,121.07848694132248
2031,929,34122,216,344,588,683,372,339,1422,126108,1.0973451327433628,503.29414858509926
2032,1222,34122,209,317,520,597,311,280,1182,87080,1.1107142857142858,418.47461093834596
2033,925,34122,218,323,590,683,372,360,1464,133920,1.0333333333333334,517.6717106429518
2034,366,33,21,380,414,652,393,272,1330,106896,1.4448529411764706,477.94664974241635
2035,1565,33,43,388,365,629,322,241,1126,77602,1.3360995850622406,402.20019890596774
2036,141,33,75,413,345,620,270,207,954,55890,1.3043478260869563,340.2190470858444
2037,955,27172,42,882,63,891,21,9,60,189,2.333333333333333,22.847319317591726
2038,79,27172,46,879,62,892,16,13,58,208,1.2307692307692308,20.615528128088304
2039,1187,27172,46,883,60,890,14,7,42,98,2.0,15.652475842498529
2040,638,27172,47,881,61,890,14,9,46,126,1.5555555555555556,16.64331697709324
2041,1719,27172,47,883,59,889,12,6,36,72,2.0,13.416407864998739
2042,340,27172,46,885,64,890,18,5,46,90,3.6,18.681541692269406
2043,242,27172,46,881,63,893,17,12,58,204,1.4166666666666667,20.808652046684813
2044,188,27172,45,881,61,890,16,9,50,144,1.7777777777777777,18.35755975068582
2045,451,17550,130,858,671,1118,541,260,1602,140660,2.080769230769231,600.2341209894686
2046,457,17550,60,734,715,1220,655,486,2282,318330,1.3477366255144032,815.610814052879
2047,1217,17550,43,912,309,1186,266,274,1080,72884,0.9708029197080292,381.8795621658745
2048,1701,17550,41,924,313,1126,272,202,948,54944,1.3465346534653466,338.803778019077
2049,737,17550,44,937,296,1156,252,219,942,55188,1.1506849315068493,333.86374466239965
2050,389,17550,84,953,234,1145,150,192,684,28800,0.78125,243.64728605096343
2051,674,17550,67,874,703,1162,636,288,1848,183168,2.208333333333333,698.1690339738651
2052,560,17550,64,928,677,1111,613,183,1592,112179,3.3497267759562837,639.7327567039224
2053,656,24861,134,563,570,1013,436,450,1772,196200,0.9688888888888888,626.5748159637443
2054,717,24861,95,532,603,1047,508,515,2046,261620,0.9864077669902912,723.3871715754987
2055,1361,24861,108,475,640,934,532,459,1982,244188,1.159041394335512,702.6414448351306
2056,831,29961,59,450,147,621,88,171,518,15048,0.5146198830409356,192.31484602078956
2057,1748,29961,41,466,144,604,103,138,482,14214,0.7463768115942029,172.20046457544765
2058,719,29961,89,520,91,521,2,1,6,2,2.0,2.23606797749979
2059,105,29961,24,455,159,608,135,153,576,20655,0.8823529411764706,204.04411287758342
2060,1295,29961,26,454,159,615,133,161,588,21413,0.8260869565217391,208.83007446246816
2061,1257,29961,29,458,163,629,134,171,610,22914,0.783625730994152,217.24870540465827
2062,1585,29961,37,460,152,610,115,150,530,17250,0.7666666666666667,189.01058171435798
2063,1635,4396,226,594,932,989,706,395,2202,278870,1.7873417721518987,808.987638966134
2064,615,4396,225,545,903,1113,678,568,2492,385104,1.1936619718309858,884.4817691733391
2065,401,4396,199,610,941,1168,742,558,2600,414036,1.3297491039426523,928.4007755274658
2066,615,35128,28,470,105,510,77,40,234,3080,1.925,86.76981041814025
2067,169,35128,32,466,89,509,57,43,200,2451,1.3255813953488371,71.40028011149536
2068,506,35128,29,469,106,516,77,47,248,3619,1.6382978723404256,90.21086409075129
2069,1082,29976,78,393,139,506,61,113,348,6893,0.5398230088495575,128.41339493993607
2071,1748,29976,69,395,135,489,66,94,320,6204,0.7021276595744681,114.85643212288984
2072,105,29976,73,396,139,476,66,80,292,5280,0.825,103.71113729971339
2073,831,29976,89,402,138,468,49,66,230,3234,0.7424242424242424,82.20097323024831
2074,1257,29976,78,393,136,491,58,98,312,5684,0.5918367346938775,113.87712676389407
2075,723,29976,67,394,68,395,1,1,4,1,1.0,1.4142135623730951
2076,761,34284,399,760,706,1075,307,315,1244,96705,0.9746031746031746,439.8567948776056
2077,814,34284,102,657,652,1082,550,425,1950,233750,1.2941176470588236,695.0719387228922
2078,292,34284,35,654,771,1200,736,546,2564,401856,1.3479853479853479,916.4125708435039
2079,1388,34284,97,684,801,1004,704,320,2048,225280,2.2,773.3149423100526
2080,138,34284,105,734,665,1006,560,272,1664,152320,2.0588235294117645,622.562446666999
2081,148,34284,39,693,690,1206,651,513,2328,333963,1.2690058479532165,828.8365339438169
2082,1339,34284,45,673,724,1168,679,495,2348,336105,1.3717171717171717,840.277335169764
2083,94,34284,44,652,745,1191,701,539,2480,377839,1.3005565862708721,884.2635353784526
2084,200,34284,35,636,816,1215,781,579,2720,452199,1.3488773747841103,972.2149967985476
2085,1019,163,56,325,213,451,157,126,566,19782,1.2460317460317458,201.30822139197394
2086,1383,163,32,317,213,465,181,148,658,26788,1.2229729729729728,233.80547470065795
2087,1023,163,30,327,159,417,129,90,438,11610,1.4333333333333331,157.29272074701996
2088,436,163,31,320,211,462,180,142,644,25560,1.2676056338028172,229.26840166058645
2089,1508,163,30,323,212,465,182,142,648,25844,1.2816901408450705,230.84193726444076
2090,1725,163,21,321,212,463,191,142,666,27122,1.3450704225352113,238.0021008310641
2091,1223,24928,48,845,105,880,57,35,184,1995,1.6285714285714286,66.88796603276258
2092,788,24928,47,850,78,874,31,24,110,744,1.2916666666666667,39.20459156782532
2093,1700,24928,50,845,98,879,48,34,164,1632,1.4117647058823528,58.82176467941097
2094,119,24928,54,846,98,876,44,30,148,1320,1.4666666666666666,53.25410782277739
2095,1594,24928,50,846,106,879,56,33,178,1848,1.6969696969696968,65.0
2096,387,24928,51,847,103,878,52,31,166,1612,1.6774193548387095,60.53924347066124
2097,501,24928,47,851,106,877,59,26,170,1534,2.269230769230769,64.47480127925948
2098,189,25331,17,248,226,387,209,139,696,29051,1.5035971223021585,251.0019920239678
2099,77,25331,25,251,222,386,197,135,664,26595,1.4592592592592593,238.81792227552774
2100,1554,25331,16,249,225,385,209,136,690,28424,1.5367647058823528,249.35316320431951
2101,957,25331,18,250,220,384,202,134,672,27068,1.507462686567164,242.404620418011
2102,941,25331,17,251,227,385,210,134,688,28140,1.5671641791044777,249.11041728518703
2103,952,25331,62,266,192,373,130,107,474,13910,1.2149532710280373,168.37161280928564
2104,852,29743,44,557,511,936,467,379,1692,176993,1.2321899736147757,601.4399388135112
2105,1183,29743,88,519,518,919,430,400,1660,172000,1.075,587.2818744010409
2106,744,29743,116,594,532,896,416,302,1436,125632,1.3774834437086092,514.0622530394544
2107,1622,2807,117,1011,223,1208,106,197,606,20882,0.5380710659898477,223.70739817896055
2108,1033,2807,94,1014,253,1246,159,232,782,36888,0.6853448275862069,281.2561110447202
2109,1245,2807,148,1015,240,1113,92,98,380,9016,0.9387755102040816,134.41726079637243
2110,1259,2807,60,991,305,1245,245,254,998,62230,0.9645669291338582,352.9036695757073
2111,823,2807,73,1002,210,1246,137,244,762,33428,0.5614754098360656,279.8303057211638
2112,601,2807,143,1012,259,1150,116,138,508,16008,0.8405797101449275,180.27756377319946
2113,1693,2807,109,1033,244,1233,135,200,670,27000,0.675,241.29857024027308
2114,1407,2807,109,1006,285,1232,176,226,804,39776,0.7787610619469026,286.44720281406137
2115,588,7778,51,1004,181,1115,130,111,482,14430,1.1711711711711712,170.94151046483705
2116,909,7778,58,1005,177,1111,119,106,450,12614,1.1226415094339623,159.3643623900902
2117,1508,7778,54,1004,99,1108,45,104,298,4680,0.4326923076923077,113.3181362359971
2118,1340,7778,69,1015,136,1102,67,87,308,5829,0.7701149425287356,109.80892495603443
2119,95,7778,50,1008,180,1114,130,106,472,13780,1.2264150943396226,167.73789077009405
2120,1389,7778,52,1007,181,1112,129,105,468,13545,1.2285714285714286,166.33099530754933
2121,494,7778,66,1014,145,1105,79,91,340,7189,0.8681318681318682,120.50726119201282
2122,536,7778,62,1007,177,1110,115,103,436,11845,1.1165048543689322,154.38264151127873
2124,703,7778,54,1006,179,1111,125,105,460,13125,1.1904761904761905,163.24827717314508
2125,206,7778,107,1076,125,1089,18,13,62,234,1.3846153846153846,22.20360331117452
2126,1562,21960,217,671,634,1011,417,340,1514,141780,1.2264705882352942,538.04181993596
2127,975,21960,241,675,674,1051,433,376,1618,162808,1.1515957446808511,573.467523056014
2128,805,21960,177,651,440,912,263,261,1048,68643,1.0076628352490422,370.52665221276595
2129,693,21960,260,704,742,964,482,260,1484,125320,1.853846153846154,547.6531749200401
2130,424,21960,258,610,639,997,381,387,1536,147447,0.9844961240310076,543.0745805135792
2131,1508,21960,220,674,692,1017,472,343,1630,161896,1.3760932944606414,583.4663657829815
2132,1546,35227,32,859,684,1094,652,235,1774,153220,2.7744680851063834,693.0577176541648
2133,1712,35227,65,898,542,1089,477,191,1336,91107,2.4973821989528795,513.819034291257
2134,1186,35227,15,667,766,1240,751,573,2648,430323,1.3106457242582896,944.6322035586126
2135,952,23395,116,334,830,547,714,213,1854,152082,3.352112676056338,745.0939538071692
2136,627,23395,183,459,429,592,246,133,758,32718,1.849624060150376,279.6515689210415
2137,752,23395,47,195,836,698,789,503,2584,396867,1.5685884691848906,935.6976007236526
2138,1378,23395,230,428,391,556,161,128,578,20608,1.2578125,205.6817930688081
2139,15,23395,74,211,837,664,763,453,2432,345639,1.6843267108167768,887.3432255897376
2140,957,23395,64,224,832,745,768,521,2578,400128,1.4740882917466411,928.0436412152178
2141,1599,12300,467,905,850,1215,383,310,1386,118730,1.2354838709677418,492.73623775809307
2142,504,12300,56,782,832,1389,776,607,2766,471032,1.2784184514003294,985.2030247619016
2143,177,12300,82,800,880,1314,798,514,2624,410172,1.5525291828793777,949.2101980067429
2144,3,12300,45,788,893,1394,848,606,2908,513888,1.3993399339933994,1042.2763549078527
2145,1045,12300,223,786,872,1217,649,431,2160,279719,1.505800464037123,779.0776598003565
2146,1219,12300,136,809,816,1365,680,556,2472,378080,1.223021582733813,878.3712199292506
2147,325,12300,229,796,821,1232,592,436,2056,258112,1.3577981651376148,735.2278558379028
2148,993,12300,453,897,870,1279,417,382,1598,159294,1.0916230366492146,565.5201145847954
2149,839,12300,173,814,830,1362,657,548,2410,360036,1.198905109489051,855.5425179381793
2150,391,12300,45,768,834,1408,789,640,2858,504960,1.2328125,1015.9335608198008
2151,66,12300,86,788,850,1395,764,607,2742,463748,1.258649093904448,975.7791758384681
2152,1314,12300,70,778,806,1384,736,606,2684,446016,1.2145214521452146,953.379252973338
2153,894,18645,82,620,239,878,157,258,830,40506,0.6085271317829457,302.0149002946709
2154,891,18645,24,692,267,912,243,220,926,53460,1.1045454545454545,327.79414271765137
2155,944,18645,64,736,254,877,190,141,662,26790,1.3475177304964538,236.60304309116566
2156,240,18645,64,689,265,856,201,167,736,33567,1.2035928143712575,261.3235542388018
2157,1185,18645,31,676,266,909,235,233,936,54755,1.0085836909871244,330.9289954053588
2158,1610,18645,53,707,253,888,200,181,762,36200,1.1049723756906078,269.74246977441277
2159,800,18645,43,694,260,898,217,204,842,44268,1.0637254901960784,297.83384629689084
2160,596,10634,47,457,190,608,143,151,588,21593,0.9470198675496688,207.9663434308542
2161,805,10634,21,428,216,612,195,184,758,35880,1.059782608695652,268.1063221932672
2162,305,10634,33,464,286,634,253,170,846,43010,1.488235294117647,304.809776746088
2163,1663,10634,30,394,250,635,220,241,922,53020,0.9128630705394192,326.31426570102633
2164,1289,10634,32,431,635,682,603,251,1708,151353,2.4023904382470116,653.153886920992
2165,1239,10634,56,463,205,596,149,133,564,19817,1.1203007518796992,199.7248106770914
2166,140,10634,31,414,655,615,624,201,1650,125424,3.1044776119402986,655.5737944732081
2167,572,5496,412,800,566,926,154,126,560,19404,1.2222222222222223,198.97738564972653
2168,1420,5496,153,817,597,977,444,160,1208,71040,2.775,471.94914980323887
2169,1274,5496,203,749,620,1053,417,304,1442,126768,1.3717105263157894,516.0474784358508
2170,577,5496,158,748,569,992,411,244,1310,100284,1.6844262295081966,477.97175648776573
2171,947,5496,153,681,571,1069,418,388,1612,162184,1.077319587628866,570.3227156619312
2172,681,5496,281,770,608,995,327,225,1104,73575,1.4533333333333334,396.93072443437785
2173,1128,5496,215,829,563,900,348,71,838,24708,4.901408450704225,355.1689738701848
2174,1494,5496,186,819,646,1036,460,217,1354,99820,2.119815668202765,508.61478547128377
2175,632,5496,40,597,676,1078,636,481,2234,305916,1.3222453222453223,797.4064208419694
2176,740,5496,176,818,584,985,408,167,1150,68136,2.44311377245509,440.8548513966927
2177,952,5496,279,867,282,870,3,3,12,9,1.0,4.242640687119285
2178,909,13413,149,413,368,615,219,202,842,44238,1.0841584158415842,297.9345565724124
2179,1389,13413,77,400,381,662,304,262,1132,79648,1.1603053435114503,401.32281270817384
2180,1383,13413,70,400,349,657,279,257,1072,71703,1.0856031128404668,379.3283538044579
2181,1727,31040,45,755,139,815,94,60,308,5640,1.5666666666666669,111.51681487560519
2182,909,31040,46,771,89,808,43,37,160,1591,1.162162162162162,56.72741841473134
2183,1664,31040,49,750,134,801,85,51,272,4335,1.6666666666666667,99.12618221237011
2184,433,31040,48,754,130,815,82,61,286,5002,1.3442622950819672,102.20078277586722
2185,859,31040,49,750,141,817,92,67,318,6164,1.3731343283582091,113.81124724736128
2186,1671,31040,52,760,139,816,87,56,286,4872,1.5535714285714286,103.46496991735899
2187,207,31040,52,761,132,818,80,57,274,4560,1.4035087719298245,98.22932352408826
2188,649,31040,49,766,137,816,88,50,276,4400,1.76,101.21264743103995
2189,1573,31040,59,769,132,806,73,37,220,2701,1.9729729729729732,81.8413098624405
2190,363,31040,53,753,133,817,80,64,288,5120,1.25,102.44998779892558
2191,1096,25875,60,526,164,628,104,102,412,10608,1.0196078431372548,145.67086187704115
2192,831,25875,41,555,107,620,66,65,262,4290,1.015384615384615,92.63368717696602
2193,1515,25875,50,537,172,639,122,102,448,12444,1.196078431372549,159.02201105507376
2194,665,25875,110,531,171,622,61,91,304,5551,0.6703296703296703,109.55363982999378
2195,54,25875,49,554,120,641,71,87,316,6177,0.8160919540229885,112.29425630903836
2196,768,25875,49,547,118,647,69,100,338,6900,0.69,121.49485585818027
2197,1305,25875,61,548,170,632,109,84,386,9156,1.2976190476190477,137.6117727521886
2198,538,25875,50,546,158,636,108,90,396,9720,1.2,140.5844941663198
2199,1209,25875,39,545,123,646,84,101,370,8484,0.8316831683168316,131.36590120727678
2200,912,25875,55,555,93,637,38,82,240,3116,0.4634146341463415,90.37698822156003
2201,1398,25875,66,555,124,649,58,94,304,5452,0.6170212765957447,110.45361017187261
2202,1089,3252,36,884,416,1144,380,260,1280,98800,1.4615384615384617,460.43457732885355
2203,1078,3252,69,894,740,1180,671,286,1914,191906,2.3461538461538463,729.4086646044177
2204,260,3252,65,963,734,1178,669,215,1768,143835,3.1116279069767443,702.6990821112548
2205,1397,3252,90,883,710,1200,620,317,1874,196540,1.9558359621451105,696.3397159433031
2206,1245,3252,69,932,693,1169,624,237,1722,147888,2.632911392405063,667.4915729805134
2207,605,3252,105,905,744,1160,639,255,1788,162945,2.5058823529411764,688.0014534868368
2208,401,5143,319,767,976,1184,657,417,2148,273969,1.5755395683453235,778.163221952824
2209,559,5143,177,660,979,1220,802,560,2724,449120,1.4321428571428572,978.1635855009121
2210,567,5143,241,693,870,1202,629,509,2276,320161,1.2357563850687625,809.148935610744
2211,505,5143,534,776,770,907,236,131,734,30916,1.801526717557252,269.92035862453946
2212,221,5143,277,734,282,738,5,4,18,20,1.25,6.4031242374328485
2213,1116,5143,327,654,975,1216,648,562,2420,364176,1.1530249110320283,857.7575414999276
2214,886,5143,573,727,879,1214,306,487,1586,149022,0.6283367556468172,575.1565004414016
2215,306,11211,55,254,977,892,922,638,3120,588236,1.4451410658307209,1121.2171957297123
2216,1666,11211,152,270,975,939,823,669,2984,550587,1.2301943198804186,1060.6083160149178
2217,1067,11211,19,258,983,941,964,683,3294,658412,1.411420204978038,1181.433451363216
2218,1663,11211,25,256,973,911,948,655,3206,620940,1.4473282442748092,1152.2712354302696
2219,805,11211,103,258,987,935,884,677,3122,598468,1.3057607090103398,1113.4563305311979
2220,1652,1314,232,700,884,1266,652,566,2436,369032,1.1519434628975265,863.400254806541
2221,744,1314,177,653,894,1302,717,649,2732,465333,1.1047765793528506,967.1039240950271
2222,958,1314,299,680,894,1300,595,620,2430,368900,0.9596774193548387,859.3165889240123
2223,958,1892,33,378,569,854,536,476,2024,255136,1.1260504201680672,716.8486590627062
2224,891,1892,12,281,686,870,674,589,2526,396986,1.1443123938879456,895.0960842278331
2225,744,1892,28,374,486,861,458,487,1890,223046,0.9404517453798767,668.5304779888498
2226,338,1892,113,431,171,617,58,186,488,10788,0.3118279569892473,194.83326204732086
2227,852,1892,23,412,527,857,504,445,1898,224280,1.1325842696629214,672.3399437784431
2228,1545,1892,17,398,572,856,555,458,2026,254190,1.2117903930131004,719.575569346264
2229,1610,19204,147,462,673,835,526,373,1798,196198,1.4101876675603218,644.8294348120285
2230,1718,19204,134,418,709,821,575,403,1956,231725,1.4267990074441688,702.163798554155
2231,240,19204,179,521,596,727,417,206,1246,85902,2.0242718446601944,465.1075144523038
2232,891,19204,75,378,742,842,667,464,2262,309488,1.4375,812.5176921150702
2233,1185,19204,83,329,764,848,681,519,2400,353439,1.3121387283236994,856.2254376039058
2234,800,19204,175,430,663,754,488,324,1624,158112,1.5061728395061729,585.7644577814533
2235,889,19204,154,459,685,828,531,369,1800,195939,1.4390243902439024,646.623538080698
2236,1684,17462,198,477,666,952,468,475,1886,222300,0.9852631578947368,666.8200656848892
2237,770,17462,147,494,635,921,488,427,1830,208376,1.1428571428571428,648.4388945768136
2238,1592,17462,233,518,573,864,340,346,1372,117640,0.9826589595375722,485.09380536139605
2239,768,17462,132,487,724,976,592,489,2162,289488,1.2106339468302658,767.8443852760793
2240,500,17462,89,461,658,988,569,527,2192,299863,1.079696394686907,775.5578637342284
2241,237,32086,26,431,90,534,64,103,334,6592,0.6213592233009708,121.26417442921878
2242,128,32086,21,426,89,534,68,108,352,7344,0.6296296296296297,127.62444906835053
2243,465,32086,25,430,81,532,56,102,316,5712,0.5490196078431373,116.36150566231085
2244,957,32086,26,427,84,521,58,94,304,5452,0.6170212765957447,110.45361017187261
2245,1709,32086,28,430,83,531,55,101,312,5555,0.5445544554455446,115.00434774390054
2246,191,32086,27,430,82,529,55,99,308,5445,0.5555555555555556,113.25193155085701
2247,857,3110,51,662,483,951,432,289,1442,124848,1.494809688581315,519.754749858046
2248,1383,3110,131,654,462,944,331,290,1242,95990,1.1413793103448275,440.06931272243924
2249,1288,3110,55,669,439,938,384,269,1306,103296,1.427509293680297,468.8464567425033
2250,1706,30883,113,579,724,1108,611,529,2280,323219,1.1550094517958411,808.1843849023563
2251,230,30883,128,683,483,1092,355,409,1528,145195,0.8679706601466992,541.5773259655541
2252,998,30883,128,604,694,1119,566,515,2162,291490,1.0990291262135925,765.2326443637909
2253,886,30883,94,675,483,1112,389,437,1652,169993,0.8901601830663616,585.0555529178405
2254,391,30883,113,615,477,1092,364,477,1682,173628,0.7631027253668763,600.0208329716561
2255,1411,30883,60,584,703,1122,643,538,2362,345934,1.195167286245353,838.3871420769763
2256,936,30883,150,754,474,1065,324,311,1270,100764,1.0418006430868167,449.106891508024
2257,192,3028,155,465,683,849,528,384,1824,202752,1.375,652.8705844193013
2258,577,3028,91,387,714,859,623,472,2190,294056,1.319915254237288,781.6092374070306
2259,1437,3028,81,417,710,876,629,459,2176,288711,1.3703703703703705,778.6668093607175
2260,767,14844,518,744,635,780,117,36,306,4212,3.25,122.41323457861898
2261,586,14844,371,702,650,1037,279,335,1228,93465,0.8328358208955224,435.96559497281436
2262,1076,14844,273,629,654,1020,381,391,1544,148971,0.9744245524296676,545.9322302264266
2263,1508,14844,398,695,656,1045,258,350,1216,90300,0.7371428571428571,434.8149031484547
2264,970,14844,360,664,651,943,291,279,1140,81189,1.043010752688172,403.1401741330179
2265,583,14844,319,687,537,964,218,277,990,60386,0.7870036101083032,352.4953900407777
2266,1016,14844,329,666,331,668,2,2,8,4,1.0,2.8284271247461903
2267,811,14844,466,768,639,877,173,109,564,18857,1.5871559633027523,204.47493733951845
2268,247,22822,209,818,357,973,148,155,606,22940,0.9548387096774194,214.3105223734943
2269,906,22822,104,789,422,1003,318,214,1064,68052,1.485981308411215,383.30144794926093
2270,91,22822,303,834,305,837,2,3,10,6,0.6666666666666666,3.605551275463989
2271,1200,22822,257,897,313,992,56,95,302,5320,0.5894736842105263,110.27692415006868
2272,298,22822,176,787,215,823,39,36,150,1404,1.0833333333333333,53.075418038862395
2273,422,22822,48,796,385,1009,337,213,1100,71781,1.5821596244131455,398.67028983860837
2274,89,22822,106,762,160,805,54,43,194,2322,1.255813953488372,69.02897942168927
2275,809,22822,93,780,401,1001,308,221,1058,68068,1.3936651583710409,379.0844233149128
2276,653,22822,116,815,385,1009,269,194,926,52186,1.38659793814433,331.6579563345345
2277,1580,27665,77,388,154,525,77,137,428,10549,0.5620437956204379,157.15597347857954
2278,822,27665,75,409,246,502,171,93,528,15903,1.8387096774193548,194.65353837010002
2279,1257,27665,160,408,243,540,83,132,430,10956,0.6287878787878788,155.92626462530293
2280,1034,27665,84,394,136,593,52,199,502,10348,0.2613065326633166,205.6817930688081
2281,662,27665,82,364,255,609,173,245,836,42385,0.7061224489795919,299.92332353453276
2282,1751,27665,93,366,225,545,132,179,622,23628,0.7374301675977654,222.40728405337808
2283,831,27665,43,354,247,546,204,192,792,39168,1.0625,280.14282071829007
2284,53,27665,57,394,228,512,171,118,578,20178,1.4491525423728813,207.76188293332345
2285,1081,27665,89,366,223,549,134,183,634,24522,0.73224043715847,226.81490250863146
2286,1585,27665,67,388,218,520,151,132,566,19932,1.143939393939394,200.5617112013158
2287,1557,20871,157,801,625,1166,468,365,1666,170820,1.282191780821918,593.5056865776435
2288,592,20871,193,798,608,1133,415,335,1500,139025,1.2388059701492538,533.3385416412356
2289,481,20871,175,796,611,1128,436,332,1536,144752,1.313253012048193,548.014598345701
2290,58,33144,62,828,183,924,121,96,434,11616,1.2604166666666667,154.45711378890906
2291,285,33144,56,817,182,933,126,116,484,14616,1.0862068965517242,171.26587517658035
2292,884,33144,52,819,188,928,136,109,490,14824,1.2477064220183487,174.28998823799375
2293,952,25046,69,677,109,718,40,41,162,1640,0.975609756097561,57.28001396647874
2294,186,25046,53,679,116,729,63,50,226,3150,1.26,80.43009387039157
2295,957,25046,48,676,111,729,63,53,232,3339,1.1886792452830188,82.3286098510111
2296,687,25046,59,681,106,707,47,26,146,1222,1.807692307692308,53.71219600798314
2297,1053,25046,56,680,112,731,56,51,214,2856,1.0980392156862746,75.7429864739964
2298,1123,25046,55,677,105,729,50,52,204,2600,0.9615384615384616,72.13875518748573
2299,805,21927,71,418,428,655,357,237,1188,84609,1.5063291139240509,428.5067093990478
2300,975,21927,71,464,804,986,733,522,2510,382626,1.4042145593869733,899.8738800520882
2301,592,21927,44,406,786,989,742,583,2650,432586,1.2727272727272727,943.6381721825373
2302,1070,21927,94,461,725,978,631,517,2296,326227,1.2205029013539652,815.7511875565981
2303,93,21927,95,448,779,990,684,542,2452,370728,1.2619926199261993,872.708427826843
2304,1508,21927,108,490,363,755,255,265,1040,67575,0.9622641509433962,367.76351096866586
2305,424,21927,152,477,706,974,554,497,2102,275338,1.1146881287726358,744.2613788179526
2306,1158,21618,48,682,162,778,114,96,420,10944,1.1875,149.03690818049066
2307,1406,21618,69,697,151,773,82,76,316,6232,1.0789473684210529,111.80339887498948
2308,1461,21618,51,696,123,773,72,77,298,5544,0.935064935064935,105.41821474489122
2309,556,21618,51,683,152,772,101,89,380,8989,1.1348314606741574,134.61797799699713
2310,1163,21618,64,703,162,775,98,72,340,7056,1.3611111111111112,121.60592090848209
2311,55,21618,63,683,157,771,94,88,364,8272,1.068181818181818,128.76334882255898
2312,886,34471,50,736,616,1085,566,349,1830,197534,1.6217765042979944,664.9488702148459
2313,1046,34471,64,811,580,1084,516,273,1578,140868,1.8901098901098898,583.7679333433791
2314,169,34471,135,764,490,1042,355,278,1266,98690,1.276978417266187,450.8979928986156
2315,1704,34471,50,742,622,1097,572,355,1854,203060,1.6112676056338033,673.2079916340863
2316,615,34471,52,747,624,1091,572,344,1832,196768,1.662790697674419,667.4728458896287
2317,421,1293,135,519,274,665,139,146,570,20294,0.952054794520548,201.58620984581262
2318,235,1293,134,515,283,659,149,144,586,21456,1.0347222222222223,207.21245136332902
2319,941,1293,45,536,269,734,224,198,844,44352,1.1313131313131313,298.9648808806814
2320,338,1293,173,533,259,636,86,103,378,8858,0.8349514563106796,134.18271125595876
2321,854,1293,89,507,256,727,167,220,774,36740,0.759090909090909,276.20463428407567
2322,947,1293,32,506,269,739,237,233,940,55221,1.0171673819742488,332.3522227998483
2323,952,1293,95,527,266,654,171,127,596,21717,1.346456692913386,213.00234740490538
2324,853,1293,50,540,262,707,212,167,758,35404,1.2694610778443114,269.8758974047145
2325,886,35966,42,586,948,1242,906,656,3124,594336,1.3810975609756098,1118.5580002842946
2326,119,35966,57,609,958,1253,901,644,3090,580244,1.3990683229813663,1107.49130922098
2327,1698,35966,80,708,858,1167,778,459,2474,357102,1.6949891067538123,903.307810217536
2328,1562,21977,23,397,51,414,28,17,90,476,1.6470588235294117,32.7566787083184
2329,424,21977,25,396,47,414,22,18,80,396,1.2222222222222223,28.42534080710379
2330,93,21977,19,392,54,413,35,21,112,735,1.6666666666666667,40.8166632639171
2331,809,21977,18,386,51,415,33,29,124,957,1.137931034482759,43.93176527297759
2332,805,21977,29,394,49,412,20,18,76,360,1.1111111111111112,26.90724809414742
2333,592,21977,21,393,52,417,31,24,110,744,1.2916666666666667,39.20459156782532
2334,1384,8490,86,523,740,906,654,383,2074,250482,1.7075718015665795,757.8951114765156
2335,809,8490,51,501,761,902,710,401,2222,284710,1.770573566084788,815.4146184610624
2336,304,8490,68,482,779,920,711,438,2298,311418,1.6232876712328768,835.0838281274521
2337,1560,8490,185,567,449,807,264,240,1008,63360,1.1,356.78564993564413
2338,1443,8490,156,564,455,871,299,307,1212,91793,0.973941368078176,428.54404674432243
2339,135,8490,236,537,466,866,230,329,1118,75670,0.6990881458966566,401.4237162899073
2340,1671,8490,172,550,505,838,333,288,1242,95904,1.15625,440.2646931108603
2341,909,8490,119,553,308,908,189,355,1088,67095,0.5323943661971829,402.17657813453036
2342,375,23225,98,1103,248,1236,150,133,566,19950,1.1278195488721805,200.47194317410106
2343,982,23225,91,1113,247,1234,156,121,554,18876,1.2892561983471074,197.4259354796122
2344,1684,23225,107,1111,238,1233,131,122,506,15982,1.0737704918032789,179.0111728356641
2345,1400,23225,133,1098,207,1198,74,100,348,7400,0.74,124.4025723206719
2346,710,23225,118,1097,229,1226,111,129,480,14319,0.8604651162790697,170.182255244194
2347,1090,23225,123,1111,229,1210,106,99,410,10494,1.0707070707070707,145.04137340772803
2348,1357,23225,101,1104,257,1241,156,137,586,21372,1.1386861313868613,207.6174366473105
2349,1630,23225,132,1106,208,1223,76,117,386,8892,0.6495726495726496,139.51702405083043
2350,1159,23225,99,1083,256,1253,157,170,654,26690,0.923529411764706,231.40656861895687
2351,706,23225,123,1123,241,1182,118,59,354,6962,2.0,131.9280106724876
2352,1742,225,39,706,102,756,63,50,226,3150,1.26,80.43009387039157
2353,714,225,57,708,92,750,35,42,154,1470,0.8333333333333334,54.67174773134658
2354,379,225,51,713,71,721,20,8,56,160,2.5,21.540659228538015
2355,1243,225,49,709,74,728,25,19,88,475,1.3157894736842106,31.400636936215164
2356,831,225,40,709,106,758,66,49,230,3234,1.3469387755102042,82.20097323024831
2357,1351,225,47,710,74,732,27,22,98,594,1.2272727272727273,34.828149534535996
2358,1360,225,45,705,106,759,61,54,230,3294,1.1296296296296295,81.46778504415104
2359,382,225,39,707,107,758,68,51,238,3468,1.3333333333333333,85.0
2360,1342,4063,105,747,618,1140,513,393,1812,201609,1.3053435114503815,646.23370385643
2361,1506,4063,57,780,496,1158,439,378,1634,165942,1.1613756613756614,579.3142497815844
2362,1389,4063,46,777,574,1131,528,354,1764,186912,1.4915254237288136,635.6886030125128
2363,1562,4063,61,716,635,1143,574,427,2002,245098,1.3442622950819672,715.4054794310706
2364,972,4063,106,710,543,1152,437,442,1758,193154,0.98868778280543,621.5569161388199
2365,573,9306,60,506,231,671,171,165,672,28215,1.0363636363636364,237.6257561797542
2366,71,9306,91,515,202,658,111,143,508,15873,0.7762237762237763,181.02486017119307
2367,887,9306,87,506,228,670,141,164,610,23124,0.8597560975609756,216.27991122617004
2368,941,9306,51,509,100,648,49,139,376,6811,0.3525179856115108,147.38385257551113
2369,13,9306,56,511,234,669,178,158,672,28124,1.1265822784810129,238.00840321299583
2370,748,9306,99,520,212,595,113,75,376,8475,1.5066666666666666,135.6244815658294
2371,1543,9306,67,514,217,642,150,128,556,19200,1.171875,197.1902634513175
2372,469,9306,69,508,233,660,164,152,632,24928,1.0789473684210529,223.60679774997897
2373,1181,9306,70,510,238,668,168,158,652,26544,1.0632911392405062,230.62523712724936
2374,941,25130,77,697,300,831,223,134,714,29882,1.6641791044776117,260.16341018675166
2375,12,25130,33,684,264,836,231,152,766,35112,1.5197368421052633,276.52305509667724
2376,242,25130,67,682,288,816,221,134,710,29614,1.6492537313432836,258.4511559269952
2377,1554,25130,34,666,285,835,251,169,840,42419,1.4852071005917158,302.59213472924245
2378,189,25130,34,672,287,816,253,144,794,36432,1.7569444444444444,291.10994486619654
2379,1123,25130,89,680,264,807,175,127,604,22225,1.3779527559055118,216.22673285234646
2380,952,25130,105,689,272,771,167,82,498,13694,2.0365853658536586,186.04569331215382
2381,77,25130,60,683,272,820,212,137,698,29044,1.5474452554744529,252.41434190631878
2382,660,21621,148,749,391,1040,243,291,1068,70713,0.8350515463917526,379.11739606617897
2383,547,21621,71,732,461,1065,390,333,1446,129870,1.1711711711711712,512.8245313945112
2384,1158,21621,96,729,431,1066,335,337,1344,112895,0.9940652818991098,475.17786143716756
2385,941,1384,34,417,186,502,152,85,474,12920,1.7882352941176471,174.15223225672418
2386,338,1384,34,444,118,486,84,42,252,3528,2.0,93.91485505499116
2387,240,1384,46,431,150,529,104,98,404,10192,1.0612244897959184,142.89856542317
2388,854,1384,48,429,130,504,82,75,314,6150,1.0933333333333333,111.12605455067681
2389,947,1384,38,417,175,487,137,70,414,9590,1.957142857142857,153.8473269186046
2390,468,1384,33,418,140,495,107,77,368,8239,1.3896103896103895,131.8256424221024
2391,421,1384,39,431,111,493,72,62,268,4464,1.1612903225806452,95.01578816175763
2392,852,1384,27,418,186,492,159,74,466,11766,2.1486486486486487,175.37673733993344
2393,853,1384,33,429,124,493,91,64,310,5824,1.421875,111.25196627475849
2394,60,459,20,339,229,479,209,140,698,29260,1.4928571428571429,251.55715056424057
2395,886,459,21,338,227,492,206,154,720,31724,1.3376623376623376,257.2003110418026
2396,1112,459,19,336,229,490,210,154,728,32340,1.3636363636363635,260.41505332833583
2397,934,33086,86,943,557,1273,471,330,1602,155430,1.4272727272727272,575.1008607192307
2398,1270,33086,351,1028,525,1216,174,188,724,32712,0.9255319148936171,256.1640099623677
2399,884,33086,79,937,551,1268,472,331,1606,156232,1.4259818731117824,576.4937120212154
2400,58,33086,156,948,527,1241,371,293,1328,108703,1.266211604095563,472.74728978599126
2401,1210,9606,68,598,286,818,218,220,876,47960,0.990909090909091,309.7159989409653
2402,1588,9606,35,593,248,797,213,204,834,43452,1.0441176470588236,294.93219559756443
2403,1511,9606,62,603,296,821,234,218,904,51012,1.073394495412844,319.81244503614926
2404,853,20618,125,1005,343,1201,218,196,828,42728,1.1122448979591837,293.1552489722809
2405,70,20618,102,996,346,1206,244,210,908,51240,1.161904761904762,321.9254572102057
2406,1182,20618,125,1030,325,1212,200,182,764,36400,1.0989010989010992,270.4144966528237
2407,169,35110,174,1037,497,1673,323,636,1918,205428,0.5078616352201258,713.319703919638
2408,1046,35110,168,1017,449,1644,281,627,1816,176187,0.4481658692185008,687.0880584029968
2409,615,35110,219,1023,486,1719,267,696,1926,185832,0.3836206896551724,745.4562361399896
2410,886,35110,191,999,531,1653,340,654,1988,222360,0.5198776758409785,737.0997218830028
2411,1704,35110,62,1025,619,1815,557,790,2694,440030,0.7050632911392405,966.6172975898993
2412,506,35110,202,1031,503,1705,301,674,1950,202874,0.4465875370919881,738.1578421990787
2413,1361,7939,42,517,259,706,217,189,812,41013,1.148148148148148,287.76726707532254
2414,161,7939,44,529,270,745,226,216,884,48816,1.0462962962962965,312.62117650600703
2415,712,7939,47,520,278,748,231,228,918,52668,1.013157894736842,324.56894491001447
2416,651,16612,152,262,434,502,282,240,1044,67680,1.175,370.30257898102735
2417,360,16612,115,151,757,695,642,544,2372,349248,1.1801470588235294,841.486779456457
2418,1730,16612,92,171,656,541,564,370,1868,208680,1.5243243243243243,674.5339131578189
2419,1344,16612,60,109,794,717,734,608,2684,446272,1.2072368421052628,953.1106966139872
2420,1452,16612,55,109,792,674,737,565,2604,416405,1.304424778761062,928.6517108152011
2421,909,16612,144,147,769,691,625,544,2338,340000,1.1488970588235294,828.5897658069402
2422,947,1263,475,841,804,1192,329,351,1360,115479,0.9373219373219374,481.084192215874
2423,952,1263,110,867,811,904,701,37,1476,25937,18.94594594594595,701.9757830580767
2424,421,1263,65,836,833,1212,768,376,2288,288768,2.042553191489361,855.102333057278
2425,854,1263,109,800,773,1222,664,422,2172,280208,1.5734597156398105,786.7528201411164
2426,468,1263,79,808,830,1185,751,377,2256,283127,1.9920424403183024,840.3154169715084
2427,338,1263,116,813,195,1167,79,354,866,27966,0.2231638418079096,362.70787143374764
2428,941,1263,82,848,873,1217,791,369,2320,291879,2.1436314363143634,872.8356088061486
2429,853,1263,61,765,479,1101,418,336,1508,140448,1.244047619047619,536.3021536410236
2430,235,1263,76,766,870,1217,794,451,2490,358094,1.7605321507760532,913.14675709877
2431,60,442,33,674,209,815,176,141,634,24816,1.2482269503546102,225.51496624392803
2432,886,442,35,672,197,807,162,135,594,21870,1.2,210.87674124947966
2433,1311,442,54,674,206,799,152,125,554,19000,1.216,196.7968495682794
2434,1062,33972,43,589,739,945,696,356,2104,247776,1.9550561797752808,781.7621121543305
2435,952,33972,197,664,469,750,272,86,716,23392,3.1627906976744184,285.27180021866866
2436,352,33972,95,647,421,882,326,235,1122,76610,1.3872340425531915,401.8718701277809
2437,415,33972,76,631,381,895,305,264,1138,80520,1.1553030303030305,403.38691104199205
2438,1487,33972,61,574,706,956,645,382,2054,246390,1.68848167539267,749.6325766667294
2439,410,33972,87,561,701,950,614,389,2006,238846,1.5784061696658098,726.8541806992652
2440,1492,33972,61,580,726,944,665,364,2058,242060,1.8269230769230769,758.1035549316465
2441,955,33972,52,540,692,976,640,436,2152,279040,1.4678899082568808,774.4004132230302
2442,1263,3747,230,771,494,977,264,206,940,54384,1.2815533980582523,334.8611652610676
2443,615,3747,225,755,390,909,165,154,638,25410,1.0714285714285714,225.7011298155151
2444,1116,3747,219,750,539,976,320,226,1092,72320,1.4159292035398232,391.76013069223876
2445,562,3747,247,767,499,965,252,198,900,49896,1.2727272727272727,320.4808886657674
2446,228,3747,202,753,568,989,366,236,1204,86376,1.5508474576271187,435.49052802558174
2447,618,3747,244,791,559,958,315,167,964,52605,1.88622754491018,356.5305036038291
2448,1371,3747,230,768,515,977,285,209,988,59565,1.3636363636363635,353.42042951702723
2449,401,3747,211,765,528,989,317,224,1082,71008,1.4151785714285714,388.15589651582
2450,462,3747,268,800,344,880,76,80,312,6080,0.95,110.34491379306978
2451,1533,3747,304,799,439,897,135,98,466,13230,1.3775510204081634,166.82026255823962
2452,1635,3747,181,676,538,983,357,307,1328,109599,1.1628664495114007,470.84817085765553
2453,1045,3747,242,782,487,964,245,182,854,44590,1.3461538461538465,305.20321099228295
2454,851,21830,56,685,125,745,69,60,258,4140,1.15,91.43850392476902
2455,853,21830,76,693,106,736,30,43,146,1290,0.6976744186046512,52.43090691567332
2456,125,21830,66,682,114,744,48,62,220,2976,0.7741935483870968,78.40918313565064
2457,330,21830,57,683,131,738,74,55,258,4070,1.3454545454545457,92.20086767487604
2458,1182,21830,72,699,111,735,39,36,150,1404,1.0833333333333333,53.075418038862395
2459,1188,21830,78,700,117,735,39,35,148,1365,1.1142857142857143,52.40229002629561
2460,421,21830,74,691,111,731,37,40,154,1480,0.925,54.48853090330111
2461,1154,26192,57,357,161,448,104,91,390,9464,1.1428571428571428,138.19189556555045
2462,373,26192,23,356,179,455,156,99,510,15444,1.5757575757575757,184.76200908195386
2463,1085,26192,19,354,153,450,134,96,460,12864,1.3958333333333333,164.83931569865243
2464,1401,26192,85,386,142,438,57,52,218,2964,1.0961538461538465,77.15568676384133
2465,1307,26192,26,357,155,444,129,87,432,11223,1.4827586206896552,155.59562975867928
2466,1030,26192,61,355,153,435,92,80,344,7360,1.15,121.91800523302537
2467,379,26192,20,355,137,441,117,86,406,10062,1.3604651162790695,145.2067491544384
2468,656,26192,20,354,139,438,119,84,406,9996,1.4166666666666667,145.6605643267937
2469,1150,26192,62,366,163,445,101,79,360,7979,1.2784810126582278,128.22636234409833
2470,163,18588,33,272,610,591,577,319,1792,184063,1.8087774294670849,659.310245635543
2471,317,18588,23,226,490,650,467,424,1782,198008,1.1014150943396226,630.7654080559586
2472,774,18588,24,245,464,612,440,367,1614,161480,1.1989100817438691,572.9650949228932
2473,824,18588,174,262,541,535,367,273,1280,100191,1.3443223443223444,457.40354174404905
2474,606,18588,362,264,446,370,84,106,380,8904,0.7924528301886793,135.2479205015737
2475,1348,29009,169,250,693,660,524,410,1868,214840,1.278048780487805,665.3390113318172
2476,1201,29009,96,211,771,610,675,399,2148,269325,1.6917293233082706,784.1084108718641
2477,589,29009,101,195,755,651,654,456,2220,298224,1.4342105263157894,797.2778687509142
2478,1732,25482,97,408,235,562,138,154,584,21252,0.8961038961038961,206.7849124090053
2479,134,25482,31,396,299,571,268,175,886,46900,1.5314285714285714,320.0765533431026
2480,247,25482,99,394,266,569,167,175,684,29225,0.9542857142857144,241.89667215569543
2481,584,25482,47,394,48,395,1,1,4,1,1.0,1.4142135623730951
2482,1024,25482,58,398,295,577,237,179,832,42423,1.324022346368715,297.00168349691216
2483,805,25482,107,417,272,562,165,145,620,23925,1.137931034482759,219.65882636488797
2484,1,6544,48,683,242,779,194,96,580,18624,2.020833333333333,216.453228204155
2485,1637,6544,48,680,271,781,223,101,648,22523,2.207920792079208,244.80604567698077
2486,396,6544,39,663,272,774,233,111,688,25863,2.099099099099099,258.08913189051566
2487,1160,7629,51,773,109,857,58,84,284,4872,0.6904761904761905,102.07840124139877
2488,158,7629,61,784,112,835,51,51,204,2601,1.0,72.12489168102785
2489,161,7629,47,768,121,838,74,70,288,5180,1.0571428571428572,101.86265262597475
2490,1361,7629,83,784,124,819,41,35,152,1435,1.1714285714285717,53.907327887774215
2491,712,7629,43,774,121,847,78,73,302,5694,1.0684931506849316,106.83164325236227
2492,166,7629,62,751,63,752,1,1,4,1,1.0,1.4142135623730951
2493,266,7629,49,757,119,841,70,84,308,5880,0.8333333333333334,109.34349546269316
2494,875,7629,44,776,131,835,87,59,292,5133,1.4745762711864407,105.11898020814318
2495,1628,7629,41,777,120,837,79,60,278,4740,1.3166666666666669,99.20181449953424
2496,916,7629,51,754,132,827,81,73,308,5913,1.1095890410958904,109.04127658827184
2497,477,16510,113,582,253,684,140,102,484,14280,1.3725490196078431,173.216627377397
2498,746,16510,110,580,279,687,169,107,552,18083,1.5794392523364489,200.02499843769527
2499,410,16510,81,572,246,732,165,160,650,26400,1.03125,229.83689869122406
2500,1435,16510,34,535,310,745,276,210,972,57960,1.3142857142857145,346.8083043988422
2501,552,16036,31,848,42,871,11,23,68,253,0.4782608695652174,25.495097567963924
2502,1509,16036,34,842,57,879,23,37,120,851,0.6216216216216216,43.56604182158393
2503,548,16036,33,834,56,879,23,45,136,1035,0.5111111111111111,50.53711507397311
2504,106,16036,32,834,57,874,25,40,130,1000,0.625,47.16990566028302
2505,1629,16036,32,838,58,877,26,39,130,1014,0.6666666666666666,46.87216658103186
2506,1626,16036,39,845,54,869,15,24,78,360,0.625,28.30194339616981
2508,1681,16036,30,833,57,880,27,47,148,1269,0.5744680851063829,54.20332093147061
2509,1508,21382,218,252,776,752,558,500,2116,279000,1.1159999999999999,749.2422839108855
2510,592,21382,94,169,770,755,676,586,2524,396136,1.1535836177474403,894.6351211527524
2511,82,21382,148,303,756,748,608,445,2106,270560,1.3662921348314607,753.4513919291675
2512,1281,32171,221,427,776,910,555,483,2076,268065,1.1490683229813663,735.740443363011
2513,1654,32171,375,501,763,830,388,329,1434,127652,1.1793313069908815,508.70915069418595
2514,957,32171,334,435,676,790,342,355,1394,121410,0.9633802816901408,492.9391443170242
2515,525,32171,407,467,708,854,301,387,1376,116487,0.7777777777777778,490.2754327926293
2516,191,32171,358,435,733,846,375,411,1572,154125,0.9124087591240876,556.3685828657115
2517,783,10052,30,729,582,1154,552,425,1954,234600,1.2988235294117647,696.6555820489777
2518,66,10052,23,549,785,1184,762,635,2794,483870,1.2,991.9017088401451
2519,1219,10052,66,533,747,1199,681,666,2694,453546,1.0225225225225223,952.5318892299617
2520,514,10052,118,607,782,1143,664,536,2400,355904,1.2388059701492538,853.3416666259769
2521,566,10052,80,626,792,1231,712,605,2634,430760,1.1768595041322314,934.3281008296818
2522,886,10052,54,563,804,1202,750,639,2778,479250,1.1737089201877935,985.3024916237653
2523,379,19642,100,602,288,733,188,131,638,24628,1.4351145038167938,229.13969538253298
2524,1301,19642,129,623,289,713,160,90,500,14400,1.7777777777777777,183.5755975068582
2525,496,19642,132,625,218,705,86,80,332,6880,1.075,117.45637488020819
2526,211,19642,133,601,229,719,96,118,428,11328,0.8135593220338984,152.11837495845134
2527,309,19642,118,620,232,714,114,94,416,10716,1.2127659574468086,147.75655653811103
2528,1212,19642,122,611,229,714,107,103,420,11021,1.0388349514563109,148.51935900750448
2529,26,23911,52,459,293,641,241,182,846,43862,1.324175824175824,302.00165562460086
2530,120,23911,121,471,261,611,140,140,560,19600,1.0,197.9898987322333
2531,1238,23911,96,474,291,639,195,165,720,32175,1.181818181818182,255.44079548889601
2532,1180,23911,54,456,247,628,193,172,730,33196,1.122093023255814,258.5207922005501
2533,1493,23911,28,407,279,635,251,228,958,57228,1.100877192982456,339.09438214160963
2534,121,23911,60,438,268,635,208,197,810,40976,1.0558375634517767,286.483856438718
2535,1235,23911,34,477,324,633,290,156,892,45240,1.858974358974359,329.2962192312569
2536,1010,23911,59,494,283,588,224,94,636,21056,2.3829787234042548,242.92385638302386
2537,957,23911,73,475,252,634,179,159,676,28461,1.1257861635220126,239.4201328209472
2538,15,23911,49,467,259,622,210,155,730,32550,1.3548387096774193,261.00766272276377
2539,952,23911,147,484,276,506,129,22,302,2838,5.863636363636362,130.86252328302402
2540,289,23911,181,482,286,592,105,110,430,11550,0.9545454545454546,152.0690632574555
2541,1337,23911,114,438,270,641,156,203,718,31668,0.7684729064039408,256.0175775215444
2542,525,23911,171,465,243,581,72,116,376,8352,0.6206896551724138,136.5283853270081
2543,214,28153,172,285,289,410,117,125,484,14625,0.9359999999999999,171.21331723905124
2544,1458,28153,157,286,373,530,216,244,920,52704,0.8852459016393442,325.8711401766042
2545,153,28153,153,293,359,536,206,243,898,50058,0.8477366255144033,318.56710439089596
2546,266,28153,95,285,420,580,325,295,1240,95875,1.1016949152542372,438.91912694709487
2547,1400,28153,136,291,418,469,282,178,920,50196,1.5842696629213484,333.4786349978061
2548,917,28153,92,269,353,578,261,309,1140,80649,0.8446601941747572,404.47744065645986
2549,1138,29098,126,862,424,1113,298,251,1098,74798,1.1872509960159363,389.62161131025573
2550,806,29098,91,879,406,1109,315,230,1090,72450,1.3695652173913044,390.03204996512784
2551,1141,29098,122,884,378,1088,256,204,920,52224,1.2549019607843137,327.34080100103625
2552,382,275,138,526,657,917,519,391,1820,202929,1.3273657289002558,649.8015081546056
2553,718,275,66,515,118,651,52,136,376,7072,0.38235294117647056,145.60219778561037
2554,1351,275,322,621,661,856,339,235,1148,79665,1.4425531914893617,412.4875755704649
2555,1586,275,19,510,694,924,675,414,2178,279450,1.6304347826086956,791.8465760486687
2556,1243,275,91,515,347,868,256,353,1218,90368,0.7252124645892352,436.05618903989887
2557,1692,275,102,504,621,913,519,409,1856,212271,1.2689486552567235,660.7889224253082
2558,831,275,54,466,744,924,690,458,2296,316020,1.5065502183406114,828.1690648653812
2559,1244,32394,111,650,398,832,287,182,938,52234,1.5769230769230769,339.84261063027395
2560,1684,32394,123,675,434,842,311,167,956,51937,1.8622754491017963,353.00141642775316
2561,1351,32394,45,569,617,879,572,310,1764,177320,1.8451612903225807,650.6027974117542
2562,656,32394,126,682,430,824,304,142,892,43168,2.140845070422535,335.5294323900662
2563,1419,23357,213,298,272,388,59,90,298,5310,0.6555555555555556,107.61505470890214
2564,1378,23357,212,290,272,443,60,153,426,9180,0.392156862745098,164.34415109762804
2565,636,23357,90,249,346,536,256,287,1086,73472,0.89198606271777,384.5841910427416
2566,27,23357,118,271,299,512,181,241,844,43621,0.7510373443983402,301.40006635699336
2567,752,23357,64,255,366,539,302,284,1172,85768,1.0633802816901408,414.56000771902734
2568,957,23357,72,231,338,557,266,326,1184,86716,0.8159509202453987,420.7517082555934
2569,952,23357,206,286,261,512,55,226,562,12430,0.2433628318584071,232.59621665022843
2570,532,18998,50,815,66,829,16,14,60,224,1.1428571428571428,21.2602916254693
2571,429,18998,51,815,68,830,17,15,64,255,1.1333333333333333,22.67156809750927
2572,763,18998,52,813,67,830,15,17,64,255,0.8823529411764706,22.67156809750927
2573,432,18998,49,812,70,830,21,18,78,378,1.1666666666666667,27.65863337187866
2574,805,18998,51,813,68,829,17,16,66,272,1.0625,23.345235059857504
2575,489,18998,58,822,62,827,4,5,18,20,0.8,6.4031242374328485
2576,1585,28177,165,1150,456,1451,291,301,1184,87591,0.9667774086378738,418.6669320593639
2577,1579,28177,49,1170,484,1486,435,316,1502,137460,1.3765822784810129,537.6625335654327
2578,153,28177,158,1171,462,1419,304,248,1104,75392,1.2258064516129032,392.3263947276553
2579,157,28177,92,1143,523,1500,431,357,1576,153867,1.2072829131652658,559.6516773851392
2580,314,28177,486,1485,488,1488,2,3,10,6,0.6666666666666666,3.605551275463989
2581,610,7856,40,297,121,398,81,101,364,8181,0.801980198019802,129.46814279968643
2582,401,7856,21,303,135,399,114,96,420,10944,1.1875,149.03690818049066
2583,1698,7856,22,293,120,403,98,110,416,10780,0.8909090909090909,147.32277488562318
2584,859,31011,88,693,880,1111,792,418,2420,331056,1.8947368421052633,895.5378272300953
2585,1573,31011,80,667,748,1020,668,353,2042,235804,1.8923512747875355,755.5349098486449
2586,1664,31011,84,719,724,982,640,263,1806,168320,2.4334600760456278,691.931354976778
2587,1446,31011,476,721,719,950,243,229,944,55647,1.0611353711790392,333.9011829868232
2588,909,31011,132,722,728,1087,596,365,1922,217540,1.6328767123287669,698.88554141576
2589,1727,31011,65,684,756,1038,691,354,2090,244614,1.951977401129944,776.4000257599172
2590,1671,31011,128,716,774,980,646,264,1820,170544,2.446969696969697,697.862450630495
2591,54,2644,35,733,90,810,55,77,264,4235,0.7142857142857143,94.62557793746889
2592,1028,2644,66,763,92,793,26,30,112,780,0.8666666666666667,39.698866482558415
2593,105,2644,46,744,83,811,37,67,208,2479,0.5522388059701493,76.53757247260981
2594,96,2644,42,738,109,809,67,71,276,4757,0.943661971830986,97.62171889492625
2595,550,2644,38,733,89,811,51,78,258,3978,0.6538461538461539,93.1933474020544
2596,1352,2644,37,735,87,812,50,77,254,3850,0.6493506493506493,91.80958555619343
2597,1361,24873,65,431,612,1098,547,667,2428,364849,0.8200899550224887,862.6111522580728
2598,656,24873,133,493,595,1211,462,718,2360,331716,0.6434540389972145,853.7962286166413
2599,1030,24873,145,457,475,955,330,498,1656,164340,0.6626506024096386,597.4144290189182
2600,717,24873,87,474,655,1266,568,792,2720,449856,0.7171717171717171,974.6219779996756
2601,1085,24873,90,453,572,1236,482,783,2530,377406,0.6155810983397191,919.4634304854109
2602,1307,24873,184,468,524,1194,340,726,2132,246840,0.4683195592286502,801.6707553603287
2603,1503,19160,170,384,605,879,435,495,1860,215325,0.8787878787878788,658.9764790946639
2604,763,19160,49,362,598,883,549,521,2140,286029,1.053742802303263,756.8632637405517
2605,355,19160,29,358,557,815,528,457,1970,241296,1.1553610503282277,698.3072389715003
2606,1383,1729,340,581,595,973,255,392,1294,99960,0.6505102040816326,467.64195705689195
2607,1508,1729,92,552,316,986,224,434,1316,97216,0.5161290322580645,488.3973791903474
2608,1017,1729,107,562,799,994,692,432,2248,298944,1.601851851851852,815.774478639777
2609,1573,1729,578,425,760,736,182,311,986,56602,0.5852090032154341,360.34011711159775
2610,1445,1729,146,694,277,878,131,184,630,24104,0.7119565217391305,225.86943130932968
2611,519,35685,129,305,963,789,834,484,2636,403656,1.7231404958677683,964.2675977134148
2612,1712,35685,137,381,828,707,691,326,2034,225266,2.1196319018404908,764.0399204230104
2613,745,35685,177,239,861,710,684,471,2310,322164,1.4522292993630572,830.4799816973315
2614,849,35685,391,309,871,719,480,410,1780,196800,1.170731707317073,631.2685640834652
2615,891,35685,85,184,924,728,839,544,2766,456416,1.5422794117647058,999.9284974436922
2616,1234,35685,224,422,817,656,593,234,1654,138762,2.534188034188034,637.4990196070893
2617,1658,35685,131,290,863,742,732,452,2368,330864,1.6194690265486726,860.306921976105
2618,1430,35685,223,430,847,682,624,252,1752,157248,2.4761904761904763,672.9635948548777
2619,193,35685,157,262,917,776,760,514,2548,390640,1.4785992217898831,917.4944141519337
2620,952,35685,242,411,832,557,590,146,1472,86140,4.0410958904109595,607.7960184140728
2621,1250,35020,73,140,500,708,427,568,1990,242536,0.7517605633802817,710.6004503235274
2622,709,35020,57,187,479,654,422,467,1778,197074,0.9036402569593148,629.4227514159303
2623,656,35020,85,192,498,708,413,516,1858,213108,0.8003875968992248,660.9273787641121
2624,291,8319,223,613,418,806,195,193,776,37635,1.0103626943005182,274.36107595648474
2625,846,8319,25,504,521,936,496,432,1856,214272,1.148148148148148,657.7537533150229
2626,748,8319,97,636,373,828,276,192,936,52992,1.4375,336.2142174269256
2627,899,8319,52,607,373,853,321,246,1134,78966,1.304878048780488,404.42180950092194
2628,1430,8319,96,637,398,808,302,171,946,51642,1.7660818713450293,347.0518693221519
2629,1373,8319,237,631,376,777,139,146,570,20294,0.952054794520548,201.58620984581262
2630,1001,8319,52,504,390,892,338,388,1452,131144,0.8711340206185567,514.5755532475284
2631,124,8319,91,562,397,833,306,271,1154,82926,1.1291512915129152,408.7505351678454
2632,421,8319,192,621,386,824,194,203,794,39382,0.955665024630542,280.79351844371337
2633,1661,8319,247,654,377,821,130,167,594,21710,0.7784431137724551,211.6341182323871
2634,831,28946,83,393,832,977,749,584,2666,437416,1.2825342465753424,949.766813486342
2635,105,28946,55,422,935,1055,880,633,3026,557040,1.3902053712480251,1084.015221295347
2636,1026,28946,49,391,991,1083,942,692,3268,651864,1.3612716763005779,1168.8575618953748
2637,950,2434,141,785,280,884,139,99,476,13761,1.404040404040404,170.65169205138284
2638,575,2434,158,814,288,865,130,51,362,6630,2.5490196078431366,139.64598096615597
2639,1175,2434,170,780,285,920,115,140,510,16100,0.8214285714285714,181.1767093199344
2640,1425,2434,41,742,280,904,239,162,802,38718,1.4753086419753083,288.7299776607895
2641,1334,2434,46,747,299,926,253,179,864,45287,1.4134078212290502,309.9193443462347
2642,892,2434,97,791,220,853,123,62,370,7626,1.9838709677419355,137.7425134081704
2643,577,2434,37,762,254,887,217,125,684,27125,1.736,250.42763425788297
2644,909,17635,105,1203,525,1527,420,324,1488,136080,1.2962962962962965,530.4488665272082
2645,648,17635,89,1152,514,1523,425,371,1592,157675,1.1455525606469004,564.1506890893602
2646,1022,17635,140,1187,492,1499,352,312,1328,109824,1.1282051282051282,470.3700670748512
2647,525,22599,56,1177,400,1587,344,410,1508,141040,0.8390243902439024,535.1971599326738
2648,952,22599,175,1211,350,1447,175,236,822,41300,0.7415254237288136,293.8043566729398
2649,330,22599,69,1162,426,1637,357,475,1664,169575,0.751578947368421,594.2003029282298
2650,1188,22599,73,1194,405,1633,332,439,1542,145748,0.7562642369020501,550.4043967847641
2651,15,22599,72,1188,425,1609,353,421,1548,148613,0.838479809976247,549.4087731370878
2652,508,19461,39,217,988,865,949,648,3194,614952,1.464506172839506,1149.1322813323104
2653,997,19461,141,225,934,726,793,501,2588,397293,1.5828343313373254,938.0031982887905
2654,781,19461,36,228,832,803,796,575,2742,457700,1.3843478260869566,981.9577383981451
2655,133,13369,77,986,337,1183,260,197,914,51220,1.3197969543147208,326.20392394942155
2656,1007,13369,63,975,393,1220,330,245,1150,80850,1.3469387755102042,411.0048661512416
2657,1177,13369,83,970,371,1214,288,244,1064,70272,1.180327868852459,377.46523018683456
2658,739,13369,384,983,386,984,2,1,6,2,2.0,2.23606797749979
2659,802,13369,69,1016,291,1170,222,154,752,34188,1.4415584415584417,270.1851217221259
2660,630,13369,125,1013,292,1184,167,171,676,28557,0.9766081871345028,239.0188277102873
2661,538,25856,141,838,556,1197,415,359,1548,148985,1.1559888579387188,548.7312639170472
2662,603,25856,120,808,577,1222,457,414,1742,189198,1.1038647342995171,616.640089517378
2663,1297,25856,281,848,534,1075,253,227,960,57431,1.1145374449339207,339.90881130091344
2664,768,25856,131,812,589,1199,458,387,1690,177246,1.1834625322997416,599.6107070424944
2665,79,25856,213,805,667,1173,454,368,1644,167072,1.233695652173913,584.4142366506826
2666,1741,25856,134,822,576,1133,442,311,1506,137462,1.4212218649517685,540.4488875000114
2667,15,25856,122,806,538,1220,416,414,1660,172224,1.0048309178743962,586.900332254123
2668,723,25856,110,823,557,1196,447,373,1640,166731,1.198391420911528,582.1838197682928
2669,1482,25856,142,822,643,1202,501,380,1762,190380,1.318421052631579,628.8091920447729
2670,302,11913,133,324,800,748,667,424,2182,282808,1.57311320754717,790.3575140403234
2671,963,11913,222,228,772,800,550,572,2244,314600,0.9615384615384616,793.5263070623431
2672,909,11913,156,188,877,787,721,599,2640,431879,1.203672787979967,937.3590560718982
2673,1195,164,18,151,349,648,331,497,1656,164507,0.6659959758551308,597.1348256466039
2674,422,164,4,146,401,681,397,535,1864,212395,0.7420560747663552,666.2086760167567
2675,1508,164,6,149,349,650,343,501,1688,171843,0.6846307385229541,607.1655457945551
2676,606,18590,55,947,66,963,11,16,54,176,0.6875,19.4164878389476
2677,774,18590,53,945,69,963,16,18,68,288,0.8888888888888888,24.08318915758459
2678,317,18590,53,944,71,963,18,19,74,342,0.9473684210526316,26.1725046566048
2679,370,16857,43,678,67,696,24,18,84,432,1.3333333333333333,30.0
2680,1260,16857,41,678,68,692,27,14,82,378,1.9285714285714288,30.4138126514911
2681,1509,16857,44,677,67,695,23,18,82,414,1.2777777777777777,29.206163733020468
2682,1521,16857,43,679,69,695,26,16,84,416,1.625,30.528675044947494
2683,369,16857,45,680,62,692,17,12,58,204,1.4166666666666667,20.808652046684813
2684,264,16857,41,676,69,696,28,20,96,560,1.4,34.40930106817051
2685,442,22681,21,284,537,694,516,410,1852,211560,1.2585365853658537,659.0569019439823
2686,1083,22681,114,359,476,610,362,251,1226,90862,1.4422310756972112,440.50539156745856
2687,1406,22681,43,382,139,642,96,260,712,24960,0.3692307692307693,277.1569952211201
2688,55,22681,48,393,502,662,454,269,1446,122126,1.687732342007435,527.7092002230016
2689,1163,22681,127,306,474,697,347,391,1476,135677,0.8874680306905369,522.7714605829206
2690,1682,22681,48,333,593,700,545,367,1824,200015,1.4850136239782017,657.0494654133736
2691,365,631,302,634,854,1125,552,491,2086,271032,1.124236252545825,738.7726307870372
2692,582,631,259,568,871,1138,612,570,2364,348840,1.0736842105263158,836.3276869744299
2693,903,631,178,573,817,1089,639,516,2310,329724,1.2383720930232558,821.3263663124422
2694,648,16688,56,638,839,1220,783,582,2730,455706,1.345360824742268,975.6090405485181
2695,813,16688,344,770,541,947,197,177,748,34869,1.1129943502824857,264.83579818446
2696,909,16688,248,758,545,973,297,215,1024,63855,1.3813953488372093,366.6524239658044
2697,651,16688,416,789,536,848,120,59,358,7080,2.0338983050847457,133.71985641631537
2698,1075,16688,296,737,567,998,271,261,1064,70731,1.0383141762452108,376.2472591262294
2699,1194,16688,288,721,572,988,284,267,1102,75828,1.0636704119850189,389.80123139877327
2700,1075,17383,87,955,203,1060,116,105,442,12180,1.1047619047619048,156.46405337968207
2701,1022,17383,94,955,190,1044,96,89,370,8544,1.0786516853932584,130.9083648969767
2702,1068,17383,90,1013,116,1048,26,35,122,910,0.7428571428571429,43.60045871318328
2703,648,17383,86,953,203,1046,117,93,420,10881,1.2580645161290325,149.4590244849738
2704,909,17383,70,1017,115,1054,45,37,164,1665,1.2162162162162162,58.25804665451803
2705,1077,17383,93,1006,120,1042,27,36,126,972,0.75,45.0
2706,134,25430,180,308,484,692,304,384,1376,116736,0.7916666666666666,489.76729168044693
2707,805,25430,309,331,492,490,183,159,684,29097,1.150943396226415,242.42524621004307
2708,258,25430,206,304,503,684,297,380,1354,112860,0.7815789473684209,482.2955525401411
2709,1732,25430,280,324,526,657,246,333,1158,81918,0.7387387387387387,414.01086942253096
2710,84,25430,281,342,450,483,169,141,620,23829,1.198581560283688,220.0954338463204
2711,1024,25430,197,315,530,648,333,333,1332,110889,1.0,470.93311627024065
2712,808,30300,147,516,955,1143,808,627,2870,506616,1.2886762360446569,1022.7379918630187
2713,1284,30300,124,537,922,1116,798,579,2754,462042,1.3782383419689122,985.9234250183936
2714,491,30300,111,518,953,1144,842,626,2936,527092,1.3450479233226835,1049.209226036447
2715,1408,34455,147,351,451,683,304,332,1272,100928,0.9156626506024096,450.15552867870014
2716,169,34455,141,355,410,637,269,282,1102,75858,0.953900709219858,389.72426149779284
2717,1046,34455,42,361,443,672,401,311,1424,124711,1.2893890675241158,507.46625503574126
2718,853,1216,259,657,620,998,361,341,1404,123101,1.0586510263929618,496.59037445363356
2719,854,1216,117,659,668,1112,551,453,2008,249603,1.216335540838852,713.3091896225648
2720,240,1216,131,591,660,961,529,370,1798,195730,1.4297297297297298,645.5548001525509
2721,1508,15170,71,567,309,719,238,152,780,36176,1.5657894736842106,282.39688383549844
2722,1136,15170,97,589,297,721,200,132,664,26400,1.5151515151515151,239.63305281200255
2723,809,15170,60,566,338,748,278,182,920,50596,1.5274725274725274,332.27699288394916
2724,1562,15170,93,585,309,732,216,147,726,31752,1.4693877551020411,261.27571643763605
2725,974,15170,94,569,341,723,247,154,802,38038,1.6038961038961042,291.0755915565577
2726,880,1187,79,655,568,1157,489,502,1982,245478,0.9741035856573704,700.8031107236897
2727,1602,1187,142,655,737,1117,595,462,2114,274890,1.2878787878787878,753.305382962315
2728,924,1187,160,623,805,1123,645,500,2290,322500,1.29,816.1035473516826
2729,1159,14254,116,871,244,1008,128,137,530,17536,0.9343065693430656,187.49133313302778
2730,1589,14254,125,886,214,958,89,72,322,6408,1.2361111111111112,114.47707194019246
2731,383,14254,147,909,206,952,59,43,204,2537,1.372093023255814,73.00684899377592
2732,664,14254,123,890,220,957,97,67,328,6499,1.4477611940298507,117.88977903109328
2733,1299,14254,126,900,218,978,92,78,340,7176,1.1794871794871795,120.61509026651682
2734,552,14254,107,885,243,1016,136,131,534,17816,1.0381679389312977,188.83061192507955
2735,1684,14254,130,898,208,972,78,74,304,5772,1.054054054054054,107.5174404457249
2736,1681,14254,110,886,235,1016,125,130,510,16250,0.9615384615384616,180.34688796871433
2737,1086,14254,148,894,189,956,41,62,206,2542,0.6612903225806451,74.33034373659252
2738,161,14254,85,855,254,1110,169,255,848,43095,0.6627450980392157,305.91828974417336
2739,1514,14254,164,901,212,965,48,64,224,3072,0.75,80.0
2740,1641,15685,58,939,365,1224,307,285,1184,87495,1.0771929824561404,418.8961685191212
2741,938,15685,46,836,901,1328,855,492,2694,420660,1.7378048780487805,986.4527358165722
2742,1478,15685,84,899,851,1310,767,411,2356,315237,1.8661800486618003,870.1781426811409
2743,58,15685,96,854,364,1265,268,411,1358,110148,0.6520681265206812,490.657721838758
2744,322,15685,50,877,873,1288,823,411,2468,338253,2.002433090024331,919.9184746487049
2745,835,15685,41,743,893,1319,852,576,2856,490752,1.4791666666666667,1028.4357053311596
2746,1120,15685,120,900,353,1251,233,351,1168,81783,0.6638176638176638,421.29562067507896
2747,931,4997,341,1500,376,1502,35,2,74,70,17.5,35.05709628591621
2748,505,4997,175,1366,277,1502,102,136,476,13872,0.75,170.0
2749,567,4997,77,1375,312,1478,235,103,676,24205,2.2815533980582523,256.58137110866016
2750,886,4997,41,1370,265,1493,224,123,694,27552,1.8211382113821135,255.54842985234717
2751,1116,4997,123,1354,343,1508,220,154,748,33880,1.4285714285714286,268.54422354614144
2752,1369,4997,81,1380,296,1494,215,114,658,24510,1.8859649122807016,243.35365211970827
2753,401,4997,87,1362,320,1538,233,176,818,41008,1.3238636363636365,292.00171232374646
2754,221,4997,38,1368,296,1501,258,133,782,34314,1.9398496240601504,290.26367323521555
2755,681,5100,415,523,526,579,111,56,334,6216,1.9821428571428568,124.32618388738553
2756,632,5100,12,268,582,683,570,415,1970,236550,1.3734939759036144,705.0709184188496
2757,11,5100,23,330,551,680,528,350,1756,184800,1.508571428571429,633.4698098567918
2758,475,5100,382,433,568,604,186,171,714,31806,1.087719298245614,252.65985039178662
2759,1489,5100,37,286,570,666,533,380,1826,202540,1.4026315789473685,654.5907118192252
2760,577,5100,40,290,573,671,533,381,1828,203073,1.398950131233596,655.1717332119877
2761,1540,5100,149,342,576,614,427,272,1398,116144,1.5698529411764706,506.27364142329196
2762,1432,5100,48,297,504,683,456,386,1684,176016,1.1813471502590671,597.4378628778059
2763,572,5100,22,278,579,676,557,398,1910,221686,1.399497487437186,684.5823544322479
2764,1371,13288,29,496,197,602,168,106,548,17808,1.5849056603773586,198.6454127333425
2765,1037,13288,53,502,189,594,136,92,456,12512,1.4782608695652173,164.19500601419034
2766,1322,13288,144,500,182,565,38,65,206,2470,0.5846153846153846,75.29276193632427
2767,622,13288,27,497,197,601,170,104,548,17680,1.6346153846153846,199.28873525616044
2768,1046,13288,58,505,187,599,129,94,446,12126,1.3723404255319152,159.6151621870554
2769,391,13288,129,512,194,574,65,62,254,4030,1.0483870967741935,89.8276126811795
2770,387,13288,38,492,192,591,154,99,506,15246,1.5555555555555556,183.07648674802562
2771,1560,8446,206,554,593,875,387,321,1416,124227,1.2056074766355143,502.80214796677234
2772,256,8446,179,568,614,875,435,307,1484,133545,1.4169381107491856,532.4227643517884
2773,494,8446,172,503,645,931,473,428,1802,202444,1.105140186915888,637.8973271616679
2774,359,25739,275,634,660,826,385,192,1154,73920,2.005208333333333,430.21971131039544
2775,134,25739,47,530,629,977,582,447,2058,260154,1.3020134228187918,733.8480769205572
2776,1454,25739,93,518,650,987,557,469,2052,261233,1.187633262260128,728.1552032362331
2777,592,25739,40,511,753,990,713,479,2384,341527,1.488517745302714,858.9586718812495
2778,1508,25739,81,532,684,981,603,449,2104,270747,1.3429844097995545,751.80449586312
2779,307,25739,96,524,651,983,555,459,2028,254745,1.2091503267973855,720.2124686507448
2780,1387,25739,37,508,703,990,666,482,2296,321012,1.3817427385892116,822.1192127666158
2781,581,25739,73,533,644,988,571,455,2052,259805,1.254945054945055,730.113689777147
2782,1195,146,84,729,643,1091,559,362,1842,202358,1.5441988950276244,665.976726320072
2783,1383,146,120,735,602,1071,482,336,1636,161952,1.4345238095238095,587.554252814155
2784,422,146,45,757,634,1078,589,321,1820,189069,1.8348909657320875,670.7920691242555
2785,1725,146,106,712,628,1118,522,406,1856,211932,1.2857142857142858,661.3017465575
2786,1483,23531,36,393,636,883,600,490,2180,294000,1.2244897959183674,774.6612162745726
2787,952,23531,78,396,590,772,512,376,1776,192512,1.3617021276595744,635.2322409953701
2788,576,23531,125,372,710,947,585,575,2320,336375,1.017391304347826,820.2743443507178
2789,15,23531,42,351,667,926,625,575,2400,359375,1.0869565217391304,849.2643875731515
2790,957,23531,25,349,669,895,644,546,2380,351624,1.1794871794871795,844.3056318656177
2791,1378,23531,281,532,540,831,259,299,1116,77441,0.8662207357859532,395.5780580365903
2792,789,6770,82,1316,343,1577,261,261,1044,68121,1.0,369.10973977937783
2793,623,6770,79,1281,376,1646,297,365,1324,108405,0.8136986301369863,470.567742200844
2794,1313,6770,49,1232,386,1626,337,394,1462,132778,0.8553299492385786,518.4640778298917
2795,1393,4790,157,396,684,940,527,544,2142,286688,0.96875,757.4067599381458
2796,969,4790,68,375,524,840,456,465,1842,212040,0.9806451612903224,651.2764390026712
2797,1508,4790,12,532,534,896,522,364,1772,190008,1.434065934065934,636.380389389868
2798,1389,4790,31,308,663,945,632,637,2538,402584,0.9921507064364208,897.3254704955165
2799,1566,4790,66,325,639,938,573,613,2372,351249,0.934747145187602,839.1054760874821
2800,952,29476,107,1088,403,1184,296,96,784,28416,3.083333333333333,311.17840542042757
2801,945,29476,83,988,388,1283,305,295,1200,89975,1.0338983050847457,424.3229901855425
2802,519,29476,73,977,450,1266,377,289,1332,108953,1.3044982698961938,475.02631506054485
2803,577,29476,43,1041,164,1175,121,134,510,16214,0.9029850746268656,180.54639292990598
2804,1009,29476,50,968,356,1290,306,322,1256,98532,0.9503105590062112,444.20715887972807
2805,414,29476,69,1047,433,1244,364,197,1122,71708,1.847715736040609,413.8900820266173
2806,1486,29476,100,1039,343,1262,243,223,932,54189,1.0896860986547086,329.81509971497667
2807,1661,29476,83,1051,442,1264,359,213,1144,76467,1.6854460093896713,417.43262929483603
2808,844,29476,63,980,478,1261,415,281,1392,116615,1.4768683274021353,501.1845967305859
2809,954,29476,53,1030,386,1255,333,225,1116,74925,1.48,401.8880441117899
2810,886,30907,160,544,319,713,159,169,656,26871,0.940828402366864,232.038789860661
2811,936,30907,161,574,342,717,181,143,648,25883,1.2657342657342658,230.67292862405853
2812,1411,30907,142,538,353,744,211,206,834,43466,1.0242718446601942,294.8847232394381
2813,1585,1065,249,873,371,970,122,97,438,11834,1.2577319587628866,155.8621185535472
2814,1750,1065,62,864,384,1077,322,213,1070,68586,1.5117370892018782,386.0738271367278
2815,1684,1065,99,934,329,1095,230,161,782,37030,1.4285714285714286,280.7507791618752
2816,1694,1065,275,877,369,972,94,95,378,8930,0.9894736842105264,133.64505228402584
2817,555,1065,75,872,375,1106,300,234,1068,70200,1.2820512820512822,380.46813269970454
2818,1737,1065,61,854,366,1110,305,256,1122,78080,1.19140625,398.19718733311015
2819,607,1065,342,865,343,867,1,2,6,2,0.5,2.23606797749979
2820,604,1065,117,882,355,1064,238,182,840,43316,1.3076923076923077,299.61308382645774
2821,984,1065,107,864,375,1072,268,208,952,55744,1.2884615384615383,339.24622326563934
2822,1400,1065,269,878,367,967,98,89,374,8722,1.1011235955056178,132.38202294873727
2823,873,5314,85,451,644,950,559,499,2116,278941,1.1202404809619235,749.3210259962015
2824,1396,5314,195,460,686,989,491,529,2040,259739,0.9281663516068052,721.7492639414328
2825,1087,5314,142,450,630,998,488,548,2072,267424,0.8905109489051095,733.7901607407938
2826,1748,5314,140,449,790,978,650,529,2358,343850,1.2287334593572778,838.0578738965467
2827,1357,5314,179,430,676,980,497,550,2094,273350,0.9036363636363636,741.2887426637477
2828,1212,5314,66,414,676,999,610,585,2390,356850,1.0427350427350428,845.1774961509565
2829,256,8465,76,463,306,653,230,190,840,43700,1.2105263157894737,298.328677803526
2830,494,8465,102,426,360,675,258,249,1014,64242,1.036144578313253,358.5596184736926
2831,1560,8465,98,441,346,633,248,192,880,47616,1.2916666666666667,313.63673254260254
2832,1719,27193,43,602,688,980,645,378,2046,243810,1.7063492063492065,747.6021669310489
2833,1190,27193,52,609,493,1020,441,411,1704,181251,1.072992700729927,602.8283337733886
2834,337,27193,54,639,563,988,509,349,1716,177641,1.4584527220630372,617.156382126929
2835,297,18735,31,126,894,785,863,659,3044,568717,1.3095599393019728,1085.84068813063
2836,1444,18735,319,161,900,524,581,363,1888,210903,1.6005509641873281,685.0766380486201
2837,1728,18735,188,193,899,792,711,599,2620,425889,1.1869782971619365,929.6891953766054
2838,367,18735,412,125,839,606,427,481,1816,205387,0.8877338877338877,643.187375497996
2839,1502,18735,54,181,800,806,746,625,2742,466250,1.1936,973.2116933124057
2840,85,18735,19,153,866,818,847,665,3024,563255,1.2736842105263158,1076.863036787873
2841,699,18735,399,174,841,494,442,320,1524,141440,1.38125,545.6775604695506
2842,362,18735,395,116,904,543,509,427,1872,217343,1.1920374707259953,664.3869354525268
2843,550,2669,31,490,610,919,579,429,2016,248391,1.3496503496503496,720.6122396962184
2844,268,2669,127,501,603,899,476,398,1748,189448,1.1959798994974875,620.4675656309522
2845,105,2669,57,635,151,692,94,57,302,5358,1.649122807017544,109.9317970379817
2846,96,2669,73,519,545,900,472,381,1706,179832,1.2388451443569557,606.5847014226455
2847,1252,2669,45,512,593,911,548,399,1894,218652,1.3734335839598997,677.8679812470862
2848,913,2669,44,506,560,919,516,413,1858,213108,1.2493946731234866,660.9273787641121
2849,1352,2669,31,495,611,918,580,423,2006,245340,1.3711583924349882,717.8641932844959
2850,1266,9444,81,775,125,828,44,53,194,2332,0.8301886792452831,68.8839603971781
2851,1319,9444,71,758,164,891,93,133,452,12369,0.6992481203007519,162.28986413205232
2852,384,9444,79,742,157,887,78,145,446,11310,0.5379310344827586,164.64810961562844
2853,1269,9444,72,747,259,889,187,142,658,26554,1.3169014084507042,234.8041737278109
2854,566,9444,57,743,257,891,200,148,696,29600,1.351351351351351,248.8051446413438
2855,886,9444,93,757,157,888,64,131,390,8384,0.4885496183206106,145.79780519610026
2856,1597,9444,85,839,166,889,81,50,262,4050,1.62,95.1892851112981
2857,931,9444,79,828,184,888,105,60,330,6300,1.75,120.93386622447825
2858,841,9444,98,755,142,817,44,62,212,2728,0.7096774193548387,76.02631123499285
2859,952,32920,71,1041,241,1231,170,190,720,32300,0.8947368421052632,254.95097567963924
2860,957,32920,117,1025,241,1214,124,189,626,23436,0.6560846560846559,226.04645540242387
2861,128,32920,48,1033,246,1262,198,229,854,45342,0.8646288209606987,302.72925197278175
2862,1548,32920,74,1013,246,1265,172,252,848,43344,0.6825396825396826,305.1032612083981
2863,1331,32920,81,1055,227,1286,146,231,754,33726,0.6320346320346321,273.27092783536267
2864,191,32920,89,1087,237,1239,148,152,600,22496,0.9736842105263158,212.1508896988179
2865,134,31453,38,719,176,866,138,147,570,20286,0.9387755102040816,201.62589119455865
2866,1573,31453,64,736,177,841,113,105,436,11865,1.076190476190476,154.25303886795876
2867,762,31453,66,758,196,856,130,98,456,12740,1.326530612244898,162.80049139974977
2868,32,31453,39,744,160,827,121,83,408,10043,1.4578313253012047,146.7310464761974
2869,255,31453,37,739,179,889,142,150,584,21300,0.9466666666666668,206.55265672462312
2870,1196,31453,60,751,167,864,107,113,440,12091,0.9469026548672568,155.62133529821674
2871,697,31453,44,735,164,912,120,177,594,21240,0.6779661016949152,213.84340064636083
2872,761,31453,91,746,171,846,80,100,360,8000,0.8,128.06248474865697
2873,1675,31453,42,730,189,880,147,150,594,22050,0.98,210.02142747824567
2874,1508,31453,43,733,182,880,139,147,572,20433,0.9455782312925172,202.3116407921205
2875,1420,5913,139,182,476,637,337,455,1584,153335,0.7406593406593407,566.2102083148978
2876,1434,5913,80,191,504,662,424,471,1790,199704,0.9002123142250531,633.7325934493191
2877,952,5913,367,324,370,327,3,3,12,9,1.0,4.242640687119285
2878,1436,5913,83,157,549,651,466,494,1920,230204,0.9433198380566802,679.111183827803
2879,947,5913,113,154,498,638,385,484,1738,186340,0.7954545454545454,618.4504830623063
2880,69,5913,74,166,378,609,304,443,1494,134672,0.6862302483069977,537.2755345258148
2881,1641,16278,124,313,535,609,411,296,1414,121656,1.3885135135135136,506.49481734762105
2882,938,16278,64,364,447,701,383,337,1440,129071,1.1364985163204748,510.1548784437918
2883,322,16278,12,461,347,702,335,241,1152,80735,1.3900414937759336,412.68147523241214
2884,1478,16278,36,496,466,690,430,194,1248,83420,2.216494845360825,471.7372149830878
2885,58,16278,99,463,462,650,363,187,1100,67881,1.9411764705882355,408.3356462519529
2886,835,16278,23,269,599,701,576,432,2016,248832,1.3333333333333333,720.0
2887,1117,16278,47,449,359,672,312,223,1070,69576,1.3991031390134527,383.500977834477
2888,1573,62,116,984,265,1071,149,87,472,12963,1.7126436781609196,172.53985046939155
2889,144,62,71,953,627,1205,556,252,1616,140112,2.2063492063492065,610.4424624811088
2890,1508,62,98,1054,553,1259,455,205,1320,93275,2.2195121951219514,499.0490957811666
2891,1565,62,105,989,639,1083,534,94,1256,50196,5.680851063829786,542.2102913077176
2892,366,62,35,824,615,1262,580,438,2036,254040,1.3242009132420092,726.8039625648721
2893,141,62,125,980,623,1130,498,150,1296,74700,3.32,520.099990386464
2894,903,62,86,970,626,1163,540,193,1466,104220,2.7979274611398965,573.4535726630361
2895,100,4625,32,625,59,651,27,26,106,702,1.0384615384615383,37.48332962798263
2896,1404,4625,33,624,58,650,25,26,102,650,0.9615384615384616,36.069377593742864
2897,661,4625,52,624,59,651,7,27,68,189,0.25925925925925924,27.892651361962706
2898,873,4625,35,625,58,650,23,25,96,575,0.92,33.97057550292606
2899,1396,4625,32,624,57,651,25,27,104,675,0.925925925925926,36.796738985948195
2900,831,10723,51,646,965,1202,914,556,2940,508184,1.643884892086331,1069.828023562666
2901,917,10723,103,646,944,1248,841,602,2886,506282,1.3970099667774087,1034.2557710740607
2902,1743,10723,465,637,961,1216,496,579,2150,287184,0.8566493955094991,762.4021248658742
2903,831,26427,80,472,575,1190,495,718,2426,355410,0.6894150417827298,872.0946049598059
2904,379,26427,78,549,555,1075,477,526,2006,250902,0.9068441064638784,710.0739398119043
2905,1585,26427,104,482,557,1097,453,615,2136,278595,0.7365853658536585,763.8285147858778
2906,1029,26427,115,462,599,1204,484,742,2452,359128,0.6522911051212938,885.9006716331126
2907,1743,26427,63,437,631,1169,568,732,2600,415776,0.7759562841530054,926.5246893634297
2908,266,26427,133,486,572,1136,439,650,2178,285350,0.6753846153846154,784.3602488652774
2909,153,26427,137,508,534,1107,397,599,1992,237803,0.662771285475793,718.6167267744329
2910,1242,9098,16,244,666,657,650,413,2126,268450,1.5738498789346247,770.1097324407737
2911,861,9098,146,265,673,666,527,401,1856,211327,1.3142144638403992,662.2159768534734
2912,809,9098,23,243,693,690,670,447,2234,299490,1.4988814317673378,805.4247326721473
2913,1116,3769,115,260,934,882,819,622,2882,509418,1.3167202572347267,1028.4186890561646
2914,462,3769,119,221,923,815,804,594,2796,477576,1.3535353535353536,999.625930035831
2915,1045,3769,51,442,588,825,537,383,1840,205671,1.4020887728459528,659.5892661346151
2916,1241,23012,135,451,431,735,296,284,1160,84064,1.0422535211267605,410.20970246935894
2917,805,23012,91,393,497,740,406,347,1506,140882,1.170028818443804,534.083326832059
2918,1500,23012,116,404,455,776,339,372,1422,126108,0.9112903225806452,503.29414858509926
2919,247,23012,128,390,448,728,320,338,1316,108160,0.9467455621301776,465.45031958308937
2920,761,23012,78,388,435,781,357,393,1500,140301,0.9083969465648856,530.9406746520744
2921,1508,23012,44,396,483,779,439,383,1644,168137,1.1462140992167102,582.589048987363
2922,169,35118,76,729,415,894,339,165,1008,55935,2.0545454545454547,377.0225457449461
2923,506,35118,58,750,467,905,409,155,1128,63395,2.638709677419355,437.38541356565605
2924,615,35118,79,738,495,915,416,177,1186,73632,2.3502824858757063,452.0895928906128
2925,1046,35118,66,769,495,884,429,115,1088,49335,3.730434782608696,444.14637226932297
2926,1704,35118,52,661,509,957,457,296,1506,135272,1.5439189189189189,544.4859961468247
2927,886,35118,77,728,504,875,427,147,1148,62769,2.9047619047619047,451.5949512561007
2928,1574,5271,46,411,694,1135,648,724,2744,469152,0.8950276243093923,971.6377925955742
2929,696,5271,91,428,652,1079,561,651,2424,365211,0.8617511520737328,859.373027270463
2930,1065,5271,325,646,474,910,149,264,826,39336,0.5643939393939394,303.14517974066484
2931,969,5271,253,554,638,870,385,316,1402,121660,1.2183544303797469,498.07730323715816
2932,490,5271,56,344,736,1197,680,853,3066,580040,0.7971864009378663,1090.8753365990085
2933,137,5271,28,292,734,1197,706,905,3222,638930,0.7801104972375691,1147.8070395323423
2934,819,5271,122,342,744,1205,622,863,2970,536786,0.7207415990730012,1063.791802938902
2935,143,5271,11,386,719,1165,708,779,2974,551532,0.9088575096277278,1052.665663921836
2936,967,5271,119,373,708,1218,589,845,2868,497705,0.6970414201183432,1030.0223298550377
2937,1508,5271,17,638,167,1184,150,546,1392,81900,0.27472527472527475,566.2296353953933
2938,1432,5461,177,532,311,566,134,34,336,4556,3.941176470588236,138.24615727028365
2939,1274,5461,41,524,323,696,282,172,908,48504,1.6395348837209305,330.3150011731226
2940,632,5461,28,514,329,709,301,195,992,58695,1.5435897435897437,358.6446709488376
2941,572,5461,34,524,141,637,107,113,440,12091,0.9469026548672568,155.62133529821674
2942,1494,5461,46,540,325,689,279,149,856,41571,1.87248322147651,316.2941668763431
2943,1128,5461,35,547,302,680,267,133,800,35511,2.007518796992481,298.29180344085887
2944,681,5461,53,544,300,689,247,145,784,35815,1.703448275862069,286.41578168809065
2945,952,5461,52,547,300,685,248,138,772,34224,1.7971014492753623,283.8097954616789
2946,947,5461,186,534,311,690,125,156,562,19500,0.8012820512820513,199.90247622278218
2947,577,5461,44,519,189,673,145,154,598,22330,0.9415584415584416,211.52068456772733
2948,768,16996,150,173,636,405,486,232,1436,112752,2.0948275862068964,538.5350499271148
2949,369,16996,174,143,577,401,403,258,1322,103974,1.562015503875969,478.51123288800653
2950,1592,16996,179,116,635,403,456,287,1486,130872,1.5888501742160281,538.7995916850717
2951,1601,1408,519,671,602,801,83,130,426,10790,0.6384615384615384,154.23683088030563
2952,935,1408,62,596,706,1025,644,429,2146,276276,1.5011655011655012,773.8068234385117
2953,1607,1408,33,565,632,945,599,380,1958,227620,1.576315789473684,709.3666188932208
2954,1413,1408,384,681,627,863,243,182,850,44226,1.335164835164835,303.60006587614566
2955,886,1408,156,662,604,865,448,203,1302,90944,2.2068965517241383,491.84652077655284
2956,279,1408,84,633,647,985,563,352,1830,198176,1.599431818181818,663.9826804970141
2957,798,1408,93,599,707,960,614,361,1950,221654,1.7008310249307481,712.2618900376461
2958,1602,1408,56,561,658,996,602,435,2074,261870,1.3839080459770114,742.7173082674188
2959,1046,1408,86,718,611,834,525,116,1282,60900,4.525862068965517,537.6625335654327
2960,909,11463,166,790,455,989,289,199,976,57511,1.4522613065326633,350.88744634141585
2961,1665,11463,239,842,360,980,121,138,518,16698,0.8768115942028986,183.53473785635242
2962,1508,11463,146,769,298,991,152,222,748,33744,0.6846846846846847,269.05018119302576
2963,487,11463,176,754,351,980,175,226,802,39550,0.7743362831858407,285.83386783234766
2964,1197,11463,183,787,330,924,147,137,568,20139,1.072992700729927,200.94277792446286
2965,202,11463,152,783,349,950,197,167,728,32899,1.1796407185628743,258.25955935840983
2966,150,11463,174,788,451,967,277,179,912,49583,1.5474860335195533,329.802971484491
2967,1565,11463,174,754,468,1001,294,247,1082,72618,1.1902834008097165,383.98567681620625
2968,201,11463,130,756,461,994,331,238,1138,78778,1.3907563025210083,407.6824744822863
2969,963,11463,155,836,427,884,272,48,640,13056,5.666666666666668,276.2028240261131
2970,805,11463,131,767,387,1003,256,236,984,60416,1.0847457627118644,348.1838594765702
2971,8,29814,43,512,333,819,290,307,1194,89030,0.9446254071661238,422.3138643236805
2972,113,29814,96,511,326,807,230,296,1052,68080,0.777027027027027,374.8546384933765
2973,385,29814,34,504,502,818,468,314,1564,146952,1.4904458598726114,563.5778562008979
2974,841,29814,64,550,328,805,264,255,1038,67320,1.0352941176470591,367.04359414107745
2975,1365,29814,225,611,307,682,82,71,306,5822,1.1549295774647887,108.4665847162157
2976,675,29814,64,561,477,662,413,101,1028,41713,4.089108910891089,425.1705540133277
2977,560,29814,72,569,331,797,259,228,974,59052,1.1359649122807018,345.05796614482034
2978,881,29814,199,554,356,732,157,178,670,27946,0.8820224719101124,237.34573937612615
2979,1219,29814,79,560,327,796,248,236,968,58528,1.0508474576271187,342.3448553724738
2980,1225,29814,29,563,344,772,315,209,1048,65835,1.5071770334928232,378.02909940902697
2981,819,4585,133,393,664,783,531,390,1842,207090,1.3615384615384616,658.8330592798148
2982,42,4585,116,402,671,795,555,393,1896,218115,1.4122137404580153,680.0544095879388
2983,1508,4585,197,382,418,570,221,188,818,41548,1.175531914893617,290.1465147128257
2984,294,4585,151,397,523,787,372,390,1524,145080,0.953846153846154,538.965676087077
2985,1021,4585,94,401,555,819,461,418,1758,192698,1.1028708133971292,622.2901252631284
2986,1393,4585,138,407,667,811,529,404,1866,213716,1.3094059405940597,665.6252699529969
2987,1389,4585,136,399,614,796,478,397,1750,189766,1.2040302267002518,621.3638225709636
2988,969,4585,153,435,310,692,157,257,828,40349,0.6108949416342413,301.16108646370634
2989,423,4585,141,431,659,788,518,357,1750,184926,1.4509803921568627,629.1049197073569
2990,696,4585,186,415,464,763,278,348,1252,96744,0.7988505747126436,445.4076784250581
2991,166,6658,116,501,323,566,207,65,544,13455,3.1846153846153844,216.96543503516867
2992,1621,6658,124,394,391,685,267,291,1116,77697,0.9175257731958762,394.9303736103365
2993,875,6658,239,396,386,649,147,253,800,37191,0.5810276679841897,292.60553651631403
2994,161,6658,89,387,395,708,306,321,1254,98226,0.9532710280373832,443.4828068820707
2995,266,6658,99,393,391,697,292,304,1192,88768,0.9605263157894736,421.5210552273753
2996,1628,6658,121,402,403,700,282,298,1160,84036,0.9463087248322148,410.2779545625136
2997,768,27833,23,533,859,925,836,392,2456,327712,2.1326530612244903,923.3417568809504
2998,912,27833,439,382,877,592,438,210,1296,91980,2.085714285714286,485.74067155221826
2999,1515,27833,30,403,871,914,841,511,2704,429751,1.6457925636007829,984.0741841954803
3000,997,19070,112,1184,579,1534,467,350,1634,163450,1.3342857142857143,583.600034270047
3001,781,19070,104,1218,647,1621,543,403,1892,218829,1.347394540942928,676.2085477129078
3002,1473,19070,111,1174,612,1609,501,435,1872,217935,1.1517241379310346,663.4952901113918
3003,128,33560,54,850,107,890,53,40,186,2120,1.325,66.40030120413611
3004,957,33560,58,850,101,874,43,24,134,1032,1.7916666666666667,49.24428900898052
3005,1191,33560,62,874,92,882,30,8,76,240,3.75,31.04834939252005
3006,952,33560,54,855,107,886,53,31,168,1643,1.7096774193548387,61.40032573203501
3007,525,33560,61,852,96,879,35,27,124,945,1.2962962962962965,44.204072210600685
3008,191,33560,58,862,100,879,42,17,118,714,2.4705882352941178,45.31004303683677
3009,533,186,456,1160,966,1476,510,316,1652,161160,1.6139240506329111,599.9633322128944
3010,1019,186,426,1076,537,1153,111,77,376,8547,1.4415584415584417,135.09256086106296
3011,1725,186,82,890,1002,1525,920,635,3110,584200,1.4488188976377954,1117.866271071813
3012,422,186,143,923,966,1533,823,610,2866,502030,1.3491803278688526,1024.4164192358496
3013,1383,186,229,948,1028,1292,799,344,2286,274856,2.3226744186046506,869.9063167950903
3014,1508,186,155,913,981,1309,826,396,2444,327096,2.0858585858585856,916.0196504442467
3015,436,186,146,916,950,1544,804,628,2864,504912,1.2802547770700636,1020.1960595885479
3016,854,1279,129,212,863,718,734,506,2480,371404,1.450592885375494,891.5110767679782
3017,338,1279,147,207,710,703,563,496,2118,279248,1.1350806451612905,750.3232636670677
3018,853,1279,70,246,771,634,701,388,2178,271988,1.806701030927835,801.214702810676
3019,592,21579,46,1208,207,1328,161,120,562,19320,1.3416666666666666,200.80089641234176
3020,966,21579,57,1216,194,1319,137,103,480,14111,1.3300970873786409,171.40011668607463
3021,805,21579,46,1210,165,1307,119,97,432,11543,1.2268041237113405,153.52524222420234
3022,1399,5740,62,874,136,942,74,68,284,5032,1.088235294117647,100.4987562112089
3023,1738,5740,51,871,136,941,85,70,310,5950,1.2142857142857142,110.11357772772621
3024,208,5740,47,869,162,941,115,72,374,8280,1.5972222222222223,135.67977004697494
3025,1565,11468,25,353,148,408,123,55,356,6765,2.2363636363636363,134.73678042761748
3026,1508,11468,30,348,85,406,55,58,226,3190,0.9482758620689656,79.93122043357026
3027,963,11468,36,362,141,400,105,38,286,3990,2.763157894736842,111.66467659918243
3028,150,11468,32,362,141,400,109,38,294,4142,2.8684210526315788,115.43396380615195
3029,202,11468,29,349,96,403,67,54,242,3618,1.2407407407407407,86.05230967266364
3030,909,11468,33,350,133,399,100,49,298,4900,2.0408163265306123,111.35977729862789
3031,299,11468,29,358,148,401,119,43,324,5117,2.7674418604651163,126.53062870309307
3032,1663,11468,27,350,148,406,121,56,354,6776,2.1607142857142856,133.33041663476493
3033,1197,11468,20,357,82,400,62,43,210,2666,1.4418604651162792,75.45197147855052
3034,1665,11468,37,365,68,383,31,18,98,558,1.7222222222222223,35.84689665786984
3035,201,11468,27,349,141,405,114,56,340,6384,2.0357142857142856,127.01181047445942
3036,805,11468,24,345,148,407,124,62,372,7688,2.0,138.63621460498698
3037,180,19414,56,752,639,1229,583,477,2120,278091,1.2222222222222223,753.2715313882504
3038,66,19414,67,780,753,1227,686,447,2266,306642,1.534675615212528,818.7826329374604
3039,1473,19414,52,799,608,1232,556,433,1978,240748,1.2840646651270209,704.7162549565605
3040,651,16625,139,1233,333,1300,194,67,522,12998,2.8955223880597014,205.24375751773792
3041,755,16625,41,1141,298,1414,257,273,1060,70161,0.9413919413919414,374.93732809631
3042,1730,16625,81,1162,339,1374,258,212,940,54696,1.2169811320754718,333.9281359813815
3043,1557,16625,47,1147,287,1410,240,263,1006,63120,0.9125475285171104,356.046345297912
3044,1501,16625,429,1123,430,1125,1,2,6,2,0.5,2.23606797749979
3045,1344,16625,125,1218,297,1362,172,144,632,24768,1.1944444444444444,224.32119828495925
3046,902,16625,44,1181,304,1409,260,228,976,59280,1.1403508771929824,345.80919594481577
3047,644,16625,47,1144,291,1410,244,266,1020,64904,0.9172932330827068,360.95983156024437
3048,909,16625,52,1161,306,1382,254,221,950,56134,1.1493212669683257,336.68531301498734
3049,591,27094,181,868,599,1114,418,246,1328,102828,1.6991869918699187,485.015463671005
3050,1286,27094,147,851,414,1083,267,232,998,61944,1.1508620689655171,353.7131606259513
3051,45,27094,158,857,619,1123,461,266,1454,122626,1.7330827067669172,532.2377288392847
3052,140,27094,156,845,597,1097,441,252,1386,111132,1.75,507.9222381428086
3053,38,27094,199,857,619,1106,420,249,1338,104580,1.686746987951807,488.2632486681749
3054,651,27094,184,903,314,995,130,92,444,11960,1.4130434782608696,159.26079241294764
3055,1498,27094,109,851,632,1127,523,276,1598,144348,1.894927536231884,591.358605247273
3056,1573,27094,157,851,579,1082,422,231,1306,97482,1.826839826839827,481.08731016313453
3057,362,27094,163,862,335,1021,172,159,662,27348,1.0817610062893082,234.23279018958897
3058,252,29084,41,430,163,477,122,47,338,5734,2.5957446808510642,130.74020039758238
3059,1141,29084,32,390,191,553,159,163,644,25917,0.9754601226993864,227.705950734714
3060,973,29084,49,417,176,515,127,98,450,12446,1.2959183673469388,160.41508657230466
3061,907,29084,90,415,166,482,76,67,286,5092,1.1343283582089552,101.31633629380802
3062,1138,29084,39,406,169,516,130,110,480,14300,1.181818181818182,170.29386365926402
3063,806,29084,34,415,190,541,156,126,564,19656,1.238095238095238,200.52929960482084
3064,648,33746,112,803,452,1075,340,272,1224,92480,1.25,435.4124481454337
3065,32,33746,118,824,437,1088,319,264,1166,84216,1.2083333333333333,414.07366494381165
3066,759,33746,115,807,522,1104,407,297,1408,120879,1.3703703703703705,503.84322958634664
3067,252,28010,54,942,121,993,67,51,236,3417,1.3137254901960784,84.20213774008353
3068,698,28010,77,943,111,981,34,38,144,1292,0.8947368421052632,50.99019513592785
3069,1198,28010,80,942,107,977,27,35,124,945,0.7714285714285715,44.204072210600685
3070,818,28010,61,934,131,996,70,62,264,4340,1.1290322580645162,93.50935782048768
3071,962,28010,71,946,126,995,55,49,208,2695,1.1224489795918366,73.66138744281159
3072,44,28010,45,932,133,996,88,64,304,5632,1.375,108.81176406988355
3073,39,28010,48,933,125,997,77,64,282,4928,1.203125,100.12492197250393
3074,1671,28010,63,936,129,998,66,62,256,4092,1.064516129032258,90.55385138137417
3075,401,7888,187,350,744,718,557,368,1850,204976,1.513586956521739,667.5874474553876
3076,1479,7888,133,246,774,743,641,497,2276,318577,1.289738430583501,811.1041856629763
3077,178,7888,154,331,780,715,626,384,2020,240384,1.6302083333333333,734.3922657544808
3078,388,7888,490,345,698,551,208,206,828,42848,1.0097087378640777,292.7456233660889
3079,1319,7888,169,487,436,525,267,38,610,10146,7.026315789473684,269.69056342408425
3080,1698,7888,151,317,781,632,630,315,1890,198450,2.0,704.3614129124337
3081,387,7888,162,361,767,742,605,381,1972,230505,1.5879265091863517,714.9727267525664
3082,1500,23731,42,341,140,400,98,59,314,5782,1.6610169491525424,114.38968484964018
3083,592,23731,35,336,163,434,128,98,452,12544,1.3061224489795915,161.20794025109308
3084,971,23731,41,340,142,416,101,76,354,7676,1.3289473684210529,126.40015822774906
3085,1146,35514,26,462,104,507,78,45,246,3510,1.7333333333333334,90.0499861188218
3086,41,35514,30,461,85,511,55,50,210,2750,1.1,74.33034373659252
3087,427,35514,32,467,106,515,74,48,244,3552,1.5416666666666667,88.20430828479978
3088,1674,35514,34,466,109,514,75,48,246,3600,1.5625,89.04493247793498
3089,1508,35514,29,466,109,515,80,49,258,3920,1.6326530612244898,93.81364506296512
3090,1199,35514,33,466,67,509,34,43,154,1462,0.7906976744186046,54.817880294662984
3091,94,35514,28,461,74,508,46,47,186,2162,0.9787234042553192,65.76473218982953
3092,306,10983,60,841,280,1019,220,178,796,39160,1.2359550561797752,282.9911659398576
3093,1663,10983,69,846,317,1024,248,178,852,44144,1.3932584269662922,305.26709616334347
3094,140,10983,69,843,309,1022,240,179,838,42960,1.340782122905028,299.4010688023675
3095,201,10983,53,850,325,1027,272,177,898,48144,1.5367231638418082,324.5196450139806
3096,1561,10983,82,846,266,1015,184,169,706,31096,1.0887573964497042,249.83394485137524
3097,585,10983,64,867,110,889,46,22,136,1012,2.090909090909091,50.99019513592785
3098,1239,10983,59,859,310,1021,251,162,826,40662,1.5493827160493827,298.73901653449957
3099,805,10983,66,842,285,1025,219,183,804,40077,1.1967213114754098,285.3944638566067
3100,1502,10983,81,843,323,1026,242,183,850,44286,1.3224043715846994,303.40237309553135
3101,809,15156,76,1329,266,1449,190,120,620,22800,1.5833333333333333,224.72205054244233
3102,1136,15156,79,1315,260,1421,181,106,574,19186,1.7075471698113207,209.7546185427153
3103,1562,15156,90,1368,203,1425,113,57,340,6441,1.9824561403508767,126.56223765404908
3104,1508,15156,86,1329,249,1417,163,88,502,14344,1.8522727272727275,185.23768515072737
3105,134,25405,227,242,600,656,373,414,1574,154422,0.9009661835748792,557.2477007579305
3106,258,25405,223,217,536,601,313,384,1394,120192,0.8151041666666666,495.40387564087547
3107,1732,25405,226,206,552,615,326,409,1470,133334,0.7970660146699267,523.0267679574345
3108,120,21446,369,158,771,524,402,366,1536,147132,1.098360655737705,543.6543019235661
3109,1057,21446,291,182,729,411,438,229,1334,100302,1.9126637554585155,494.2519600365789
3110,853,21446,334,126,783,515,449,389,1676,174661,1.154241645244216,594.0723861618212
3111,342,21446,385,148,729,595,344,447,1582,153768,0.7695749440715883,564.0434380435606
3112,1182,21446,328,209,719,466,391,257,1296,100487,1.5214007782101169,467.89956187198976
3113,1609,21446,333,141,710,556,377,415,1584,156455,0.9084337349397591,560.6728101129927
3114,1600,10280,304,1060,480,1257,176,197,746,34672,0.8934010152284264,264.1685068285014
3115,1599,10280,267,1066,489,1205,222,139,722,30858,1.5971223021582734,261.92556194461054
3116,1219,10280,222,1068,503,1324,281,256,1074,71936,1.09765625,380.12761015216984
3117,3,10280,290,1084,480,1222,190,138,656,26220,1.3768115942028984,234.82759633399138
3118,1326,10280,302,1081,476,1219,174,138,624,24012,1.2608695652173914,222.08106627986098
3119,1536,10280,228,1047,577,1292,349,245,1188,85505,1.424489795918367,426.4106002434742
3120,283,10280,290,1094,497,1289,207,195,804,40365,1.0615384615384615,284.3835438276976
3121,392,10280,262,1022,583,1443,321,421,1484,135141,0.7624703087885986,529.4166601080854
3122,1411,10280,278,1053,477,1218,199,165,728,32835,1.2060606060606058,258.5072532831526
3123,782,10280,240,933,587,1330,347,397,1488,137759,0.8740554156171285,527.274122255208
3124,1696,10280,286,1040,492,1343,206,303,1018,62418,0.6798679867986799,366.3945960300179
3125,886,10280,285,1069,468,1210,183,141,648,25803,1.2978723404255321,231.01947969814148
3126,1258,22118,85,483,630,1118,545,635,2360,346075,0.8582677165354331,836.8094167730188
3127,1677,22118,175,673,373,822,198,149,694,29502,1.3288590604026846,247.8003228407905
3128,55,22118,62,514,646,1162,584,648,2464,378432,0.9012345679012346,872.3302127061747
3129,1303,22118,52,556,629,1178,577,622,2398,358894,0.927652733118971,848.4179394614425
3130,1163,22118,62,521,664,1162,602,641,2486,385882,0.939157566302652,879.3662490680433
3131,442,22118,27,404,685,1191,658,787,2890,517846,0.8360864040660737,1025.832832385472
3132,1461,22118,49,483,487,921,438,438,1752,191844,1.0,619.4255403194156
3133,1518,22118,30,400,678,1186,648,786,2868,509328,0.8244274809160306,1018.6756107809787
3134,391,30679,41,633,142,764,101,131,464,13231,0.7709923664122137,165.41463055002117
3135,118,30679,45,640,140,768,95,128,446,12160,0.7421875,159.40200751558933
3136,886,30679,40,640,133,759,93,119,424,11067,0.7815126050420168,151.02979838429235
3137,922,30679,41,641,131,766,90,125,430,11250,0.72,154.02921800749363
3138,894,19221,96,935,397,1207,301,272,1146,81872,1.1066176470588236,405.69076893614425
3139,891,19221,45,924,414,1193,369,269,1276,99261,1.3717472118959109,456.64209179618996
3140,1610,19221,90,986,389,1172,299,186,970,55614,1.60752688172043,352.13207749365864
3141,1663,11736,54,650,441,1001,387,351,1476,135837,1.1025641025641026,522.4653098531998
3142,1508,11736,100,673,510,1000,410,327,1474,134070,1.2538226299694188,524.4320737712368
3143,150,11736,106,682,398,997,292,315,1214,91980,0.926984126984127,429.52182715200865
3144,1397,3232,67,357,212,419,145,62,414,8990,2.338709677419355,157.69908052997647
3145,605,3232,120,467,261,522,141,55,392,7755,2.5636363636363635,151.34728276384746
3146,260,3232,45,360,260,497,215,137,704,29455,1.5693430656934306,254.939208439973
3147,1245,3232,44,372,275,519,231,147,756,33957,1.5714285714285714,273.80650101851126
3148,1693,3232,41,345,260,536,219,191,820,41829,1.1465968586387434,290.58905691715233
3149,1465,3232,56,373,270,512,214,139,706,29746,1.5395683453237408,255.180328395431
3150,1089,3232,111,463,268,523,157,60,434,9420,2.6166666666666667,168.07438829280326
3151,601,3232,43,353,262,514,219,161,760,35259,1.360248447204969,271.8124353299532
3152,1078,3232,37,356,263,522,226,166,784,37516,1.3614457831325302,280.4139796800438
3153,1665,12504,152,1142,504,1497,352,355,1414,124960,0.991549295774648,499.9289949582841
3154,963,12504,48,1089,570,1558,522,469,1982,244818,1.1130063965884862,701.7442554093336
3155,909,12504,54,1073,629,1489,575,416,1982,239200,1.3822115384615383,709.7048682374949
3156,437,12504,82,1093,504,1316,422,223,1290,94106,1.8923766816143497,477.29760108343305
3157,1389,12504,48,1050,814,1610,766,560,2652,428960,1.3678571428571429,948.8709079743145
3158,1668,12504,80,1104,574,1380,494,276,1540,136344,1.789855072463768,565.87277722117
3159,650,12504,149,1123,459,1483,310,360,1340,111600,0.8611111111111112,475.0789408087881
3160,584,25476,42,800,132,874,90,74,328,6660,1.2162162162162162,116.51609330903607
3161,592,25476,40,801,136,878,96,77,346,7392,1.2467532467532467,123.06502346320826
3162,1732,25476,57,814,132,864,75,50,250,3750,1.5,90.13878188659973
3163,1024,25476,48,814,128,867,80,53,266,4240,1.509433962264151,95.96353474106714
3164,1508,25476,44,825,132,864,88,39,254,3432,2.2564102564102564,96.25487000666512
3165,84,25476,55,817,142,875,87,58,290,5046,1.5,104.5609869884557
3166,359,25476,87,825,132,863,45,38,166,1710,1.1842105263157894,58.89821729050889
3167,805,25476,93,824,129,857,36,33,138,1188,1.0909090909090908,48.83646178829912
3168,83,25476,45,812,133,874,88,62,300,5456,1.4193548387096775,107.64757312638311
3169,349,24532,48,380,223,441,175,61,472,10675,2.8688524590163933,185.32673849177834
3170,803,24532,29,377,224,461,195,84,558,16380,2.321428571428572,212.32286735064596
3171,242,24532,24,369,242,468,218,99,634,21582,2.2020202020202015,239.42639787625757
3172,1228,24532,24,369,238,465,214,96,620,20544,2.2291666666666665,234.54637068179076
3173,952,24532,24,373,235,438,211,65,552,13715,3.246153846153846,220.78496325610584
3174,850,21153,164,344,685,718,521,374,1790,194854,1.3930481283422458,641.3400034303178
3175,853,21153,211,390,645,588,434,198,1264,85932,2.1919191919191916,477.03249365216203
3176,1550,21153,166,375,722,675,556,300,1712,166800,1.8533333333333333,631.7721108121187
3177,120,21153,339,380,630,623,291,243,1068,70713,1.1975308641975309,379.11739606617897
3178,1057,21153,199,344,635,672,436,328,1528,143008,1.329268292682927,545.6005865099487
3179,1721,21153,141,385,627,577,486,192,1356,93312,2.53125,522.5514328752721
3180,342,21153,293,443,687,691,394,248,1284,97712,1.5887096774193548,465.5534340975266
3181,522,21153,123,369,691,684,568,315,1766,178920,1.8031746031746032,649.4990377206112
3182,1652,21153,161,381,748,792,587,411,1996,241257,1.4282238442822384,716.5821655609356
3183,1609,21153,142,336,679,744,537,408,1890,219096,1.3161764705882353,674.4130781650072
3184,1254,3665,97,874,309,1033,212,159,742,33708,1.3333333333333333,265.0
3185,1255,3665,89,880,313,1034,224,154,756,34496,1.4545454545454546,271.8308297452664
3186,1092,3665,75,873,306,1029,231,156,774,36036,1.4807692307692308,278.7418160233588
3187,100,3665,51,883,335,1056,284,173,914,49132,1.6416184971098269,332.54323027239633
3188,13,8937,23,607,128,687,105,80,370,8400,1.3125,132.00378782444085
3189,469,8937,26,610,122,682,96,72,336,6912,1.3333333333333333,120.0
3190,1717,8937,23,608,121,681,98,73,342,7154,1.3424657534246576,122.20065466273084
3191,1543,8937,28,607,120,680,92,73,330,6716,1.2602739726027397,117.44360348695028
3192,748,8937,48,618,113,659,65,41,212,2665,1.5853658536585369,76.8505042273634
3193,29,8937,38,617,110,679,72,62,268,4464,1.1612903225806452,95.01578816175763
3194,641,8937,26,610,123,684,97,74,342,7178,1.3108108108108107,122.00409829181969
3195,421,8937,24,611,129,683,105,72,354,7560,1.4583333333333333,127.31457104353767
3196,71,8937,23,607,128,685,105,78,366,8190,1.3461538461538465,130.80137613954986
3197,242,24266,38,777,295,927,257,150,814,38550,1.7133333333333334,297.57184006555457
3198,466,24266,42,768,291,927,249,159,816,39591,1.5660377358490567,295.4352720986443
3199,1228,24266,35,759,293,939,258,180,876,46440,1.4333333333333331,314.5854414940399
3200,339,24266,50,771,252,929,202,158,720,31916,1.2784810126582278,256.45272468819667
3201,189,24266,32,767,285,897,253,130,766,32890,1.946153846153846,284.445073784026
3202,952,24266,254,842,259,850,5,8,26,40,0.625,9.433981132056603
3203,957,24266,46,803,281,894,235,91,652,21385,2.5824175824175826,252.0039682227246
3204,803,24266,45,785,271,912,226,127,706,28702,1.7795275590551183,259.2392717163046
3205,1195,114,69,575,216,758,147,183,660,26901,0.8032786885245902,234.72963170422264
3206,1383,114,41,580,197,780,156,200,712,31200,0.78,253.64542179980305
3207,1134,114,80,570,210,763,130,193,646,25090,0.6735751295336787,232.69937687926884
3208,61,27918,160,227,756,701,596,474,2140,282504,1.2573839662447257,761.5064018115672
3209,886,27918,87,224,733,734,646,510,2312,329460,1.2666666666666666,823.0528537098938
3210,1324,27918,9,180,755,729,746,549,2590,409554,1.3588342440801455,926.2380903417868
3211,1652,1364,81,420,799,998,718,578,2592,415004,1.2422145328719725,921.7418293643833
3212,1545,1364,52,444,807,1028,755,584,2678,440920,1.292808219178082,954.5056312039233
3213,1655,1364,138,532,790,902,652,370,2044,241240,1.762162162162162,749.669260407548
3214,1598,15391,140,457,614,821,474,364,1676,172536,1.3021978021978022,597.6386868334412
3215,785,15391,162,476,552,839,390,363,1506,141570,1.0743801652892562,532.7935810424145
3216,1412,15391,175,490,506,805,331,315,1292,104265,1.0507936507936508,456.93106701120684
3217,800,19263,86,654,341,742,255,88,686,22440,2.897727272727273,269.75729832573575
3218,894,19263,85,609,273,760,188,151,678,28388,1.2450331125827814,241.13274352522097
3219,891,19263,77,638,347,746,270,108,756,29160,2.5,290.7988995852632
3220,103,23237,105,753,166,821,61,68,258,4148,0.8970588235294118,91.35097153287424
3221,215,23237,57,717,277,861,220,144,728,31680,1.5277777777777777,262.9372548727167
3222,375,23237,64,717,271,876,207,159,732,32913,1.30188679245283,261.01724080987447
3223,710,23237,43,713,172,841,129,128,514,16512,1.0078125,181.72781845386248
3224,1357,23237,58,722,308,876,250,154,808,38500,1.6233766233766234,293.62561196189955
3225,1090,23237,78,738,175,834,97,96,386,9312,1.0104166666666667,136.4734406395618
3226,706,23237,105,740,147,795,42,55,194,2310,0.7636363636363637,69.20260110718382
3227,1630,23237,79,702,294,866,215,164,758,35260,1.3109756097560976,270.4089495560382
3228,1510,23237,88,736,181,826,93,90,366,8370,1.0333333333333334,129.41792766073794
3229,657,23237,44,719,297,865,253,146,798,36938,1.7328767123287672,292.1044333795706
3230,982,23237,45,708,308,866,263,158,842,41554,1.6645569620253164,306.8110167513546
3231,161,13884,95,607,474,869,379,262,1282,99298,1.4465648854961832,460.74396360668686
3232,496,13884,106,585,463,877,357,292,1298,104244,1.2226027397260273,461.20819593758307
3233,1308,13884,83,555,476,887,393,332,1450,130476,1.1837349397590362,514.463798532025
3234,134,31363,47,291,213,419,166,128,588,21248,1.296875,209.61870145576228
3235,1508,31363,38,285,221,429,183,144,654,26352,1.2708333333333333,232.86262044390037
3236,1139,31363,42,283,241,432,199,149,696,29651,1.3355704697986577,248.60008045050992
3237,755,15169,510,372,643,546,133,174,614,23142,0.7643678160919541,219.0091322296858
3238,203,15169,47,352,565,1265,518,913,2862,472934,0.5673603504928806,1049.710912584984
3239,651,15169,112,496,498,1316,386,820,2412,316520,0.4707317073170731,906.3089980795733
3240,857,15169,247,466,413,727,166,261,854,43326,0.6360153256704981,309.3169895107606
3241,1067,15169,31,334,631,1340,600,1006,3212,603600,0.5964214711729622,1171.339404271879
3242,909,15169,92,826,339,1248,247,422,1338,104234,0.5853080568720379,488.9713693049932
3243,965,15169,38,736,319,1309,281,573,1708,161013,0.4904013961605584,638.192760848946
3244,809,15169,177,478,425,690,248,212,920,52576,1.169811320754717,326.2636970304848
3245,886,1406,47,752,228,951,181,199,760,36019,0.9095477386934674,269.0018587296378
3246,1046,1406,70,776,213,948,143,172,630,24596,0.8313953488372093,223.68057582186256
3247,279,1406,49,755,276,953,227,198,850,44946,1.1464646464646464,301.21918929576844
3248,866,9216,40,793,46,799,6,6,24,36,1.0,8.48528137423857
3249,161,9216,39,792,46,799,7,7,28,49,1.0,9.899494936611665
3250,1210,9216,39,792,46,799,7,7,28,49,1.0,9.899494936611665
3251,1455,9216,40,793,47,799,7,6,26,42,1.1666666666666667,9.219544457292887
3252,261,9216,39,793,46,799,7,6,26,42,1.1666666666666667,9.219544457292887
3253,311,9216,40,792,46,799,6,7,26,42,0.8571428571428571,9.219544457292887
3254,1158,20791,117,1342,304,1584,187,242,858,45254,0.7727272727272727,305.83165303807255
3255,1623,20791,124,1334,281,1534,157,200,714,31400,0.785,254.26167623139747
3256,1521,20791,124,1335,299,1614,175,279,908,48825,0.6272401433691757,329.34176777323586
3257,608,20791,161,1375,272,1550,111,175,572,19425,0.6342857142857142,207.23416706711276
3258,1156,20791,133,1366,275,1529,142,163,610,23146,0.8711656441717791,216.17816726024856
3259,157,20791,93,1354,259,1617,166,263,858,43658,0.6311787072243346,311.0064308016797
3260,981,20791,198,1349,285,1583,87,234,642,20358,0.3717948717948718,249.64975465639858
3261,919,20791,155,1340,303,1586,148,246,788,36408,0.6016260162601627,287.08883642524313
3262,1621,20791,164,1395,281,1534,117,139,512,16263,0.8417266187050358,181.6865432551349
3263,1083,22168,160,394,613,712,453,318,1542,144054,1.4245283018867925,553.4735766050625
3264,1461,22168,57,338,614,717,557,379,1872,211103,1.469656992084433,673.7135889975799
3265,1163,22168,87,312,595,740,508,428,1872,217424,1.1869158878504673,664.2650073577563
3266,1682,22168,57,416,690,725,633,309,1884,195597,2.0485436893203883,704.3933560163667
3267,1677,22168,380,487,502,594,122,107,458,13054,1.1401869158878504,162.27445886522005
3268,55,22168,59,383,594,701,535,318,1706,170130,1.6823899371069182,622.3736819628542
3269,1357,5520,89,439,683,875,594,436,2060,258984,1.3623853211009174,736.8391954829765
3270,210,5520,199,481,557,882,358,401,1518,143558,0.8927680798004988,537.5546483847014
3271,827,5520,159,545,685,790,526,245,1542,128870,2.146938775510204,580.2594247403483
3272,873,5520,169,437,609,900,440,463,1806,203720,0.9503239740820736,638.7245102546167
3273,1683,5520,101,473,629,888,528,415,1886,219120,1.2722891566265058,671.5720363445756
3274,159,5520,183,468,607,974,424,506,1860,214544,0.8379446640316206,660.1605865242184
3275,546,5520,187,434,584,873,397,439,1672,174283,0.9043280182232346,591.8868135040685
3276,1212,5520,136,434,614,925,478,491,1938,234698,0.9735234215885948,685.2481302418854
3277,1240,18470,30,423,757,1030,727,607,2668,441289,1.1976935749588138,947.0892249413463
3278,1074,18470,48,303,848,1170,800,867,3334,693600,0.9227220299884659,1179.698690344276
3279,1567,18470,21,261,935,1171,914,910,3648,831740,1.0043956043956044,1289.7658702260655
3280,766,18470,295,316,748,957,453,641,2188,290373,0.7067082683307332,784.9140080289051
3281,699,18470,218,340,872,956,654,616,2540,402864,1.0616883116883118,898.4275151619078
3282,477,16543,343,644,487,951,144,307,902,44208,0.4690553745928338,339.09438214160963
3283,417,16543,378,668,449,715,71,47,236,3337,1.5106382978723405,85.14693182963201
3284,413,16543,345,672,492,853,147,181,656,26607,0.8121546961325967,233.173754955398
3285,801,16543,36,635,518,1062,482,427,1818,205814,1.1288056206088992,643.9355557817878
3286,959,16543,295,645,525,1015,230,370,1200,85100,0.6216216216216216,435.6604182158393
3287,521,16543,247,651,512,1020,265,369,1268,97785,0.7181571815718157,454.2972595118751
3288,897,16543,307,640,524,999,217,359,1152,77903,0.6044568245125348,419.48778289718996
3289,1721,16543,309,634,523,988,214,354,1136,75756,0.6045197740112994,413.65686262891853
3290,314,29271,366,814,367,816,1,2,6,2,0.5,2.23606797749979
3291,831,29271,135,636,393,804,258,168,852,43344,1.5357142857142858,307.87659865601995
3292,1585,29271,142,635,344,816,202,181,766,36562,1.1160220994475138,271.22868579853423
3293,423,4724,69,557,210,661,141,104,490,14664,1.3557692307692308,175.2055935180153
3294,294,4724,50,544,234,668,184,124,616,22816,1.4838709677419355,221.8828519737386
3295,1508,4724,163,556,213,673,50,117,334,5850,0.4273504273504273,127.23600119463045
3296,1389,4724,37,544,228,666,191,122,626,23302,1.5655737704918034,226.63847863944022
3297,1393,4724,56,548,239,682,183,134,634,24522,1.3656716417910448,226.81490250863146
3298,819,4724,40,548,237,676,197,128,650,25216,1.5390625,234.93190502781866
3299,42,4724,56,539,244,669,188,130,636,24440,1.446153846153846,228.56946427727394
3300,1021,4724,66,548,233,675,167,127,588,21209,1.31496062992126,209.80467106334882
3301,1324,30503,38,281,476,670,438,389,1654,170382,1.1259640102827764,585.8028678659741
3302,1477,30503,52,289,503,613,451,324,1550,146124,1.3919753086419753,555.317026571309
3303,1046,30503,106,360,304,552,198,192,780,38016,1.03125,275.80427842946887
3304,730,30503,59,299,446,599,387,300,1374,116100,1.29,489.6621284110095
3305,396,30503,69,271,468,641,399,370,1538,147630,1.0783783783783785,544.1516332788132
3306,1698,30503,91,299,398,531,307,232,1078,71224,1.3232758620689655,384.802546769119
3307,387,8516,29,412,269,641,240,229,938,54960,1.0480349344978166,331.7242831026996
3308,1698,8516,53,435,230,641,177,206,766,36462,0.8592233009708737,271.59712811441875
3309,178,8516,24,422,270,632,246,210,912,51660,1.1714285714285717,323.4439673266453
3310,1340,7448,181,793,295,952,114,159,546,18126,0.7169811320754716,195.64508682816444
3311,362,7448,691,606,695,611,4,5,18,20,0.8,6.4031242374328485
3312,1389,7448,119,531,803,937,684,406,2180,277704,1.6847290640394088,795.4193862359655
3313,492,7448,470,818,570,856,100,38,276,3800,2.631578947368421,106.97663296253066
3314,1508,7448,132,757,278,966,146,209,710,30514,0.6985645933014354,254.94509212769717
3315,1620,7448,166,560,707,973,541,413,1908,223433,1.3099273607748183,680.6247130394253
3316,194,7448,288,731,326,801,38,70,216,2660,0.5428571428571428,79.64923100695951
3317,760,7448,125,481,849,926,724,445,2338,322180,1.6269662921348316,849.8240994464678
3318,646,7448,110,480,737,901,627,421,2096,263967,1.4893111638954868,755.2284422610155
3319,1391,7448,135,644,760,975,625,331,1912,206875,1.8882175226586104,707.2382908185897
3320,809,8841,27,569,447,926,420,357,1554,149940,1.1764705882352942,551.2249994330808
3321,909,8841,49,564,440,916,391,352,1486,137632,1.1107954545454546,526.10360196448
3322,806,8841,36,568,446,924,410,356,1532,145960,1.151685393258427,542.9880293339808
3323,140,8841,177,596,179,597,2,1,6,2,2.0,2.23606797749979
3324,1671,8841,82,593,440,925,358,332,1380,118856,1.0783132530120485,488.24993599589953
3325,905,8841,193,698,441,896,248,198,892,49104,1.2525252525252526,317.34523787194286
3326,1384,8841,59,569,435,919,376,350,1452,131600,1.0742857142857145,513.688621637661
3327,433,8841,27,567,441,925,414,358,1544,148212,1.1564245810055866,547.3207469117172
3328,861,8841,92,622,442,892,350,270,1240,94500,1.2962962962962965,442.04072210600685
3329,135,8841,411,616,440,740,29,124,306,3596,0.2338709677419355,127.3459854098275
3330,809,15774,93,714,310,896,217,182,798,39494,1.1923076923076923,283.2189965380147
3331,651,15774,80,715,291,889,211,174,770,36714,1.2126436781609196,273.4904020253727
3332,1347,15774,85,713,282,840,197,127,648,25019,1.5511811023622046,234.3885662740399
3333,961,15774,39,649,321,896,282,247,1058,69654,1.1417004048582995,374.87731326395306
3334,965,15774,95,739,321,836,226,97,646,21922,2.329896907216495,245.93698379869588
3335,1370,24349,251,787,359,921,108,134,484,14472,0.8059701492537313,172.10461934532728
3336,611,24349,125,805,359,899,234,94,656,21996,2.48936170212766,252.1745427278495
3337,1700,24349,86,760,350,923,264,163,854,43032,1.6196319018404908,310.26601489689455
3338,1594,24349,110,749,362,898,252,149,802,37548,1.6912751677852351,292.7541630788536
3339,833,24349,141,750,339,899,198,149,694,29502,1.3288590604026846,247.8003228407905
3340,1470,24349,236,768,363,915,127,147,548,18669,0.8639455782312925,194.26270872197782
3341,119,24349,123,791,180,858,57,67,248,3819,0.8507462686567164,87.96590248499699
3342,1223,24349,101,773,367,909,266,136,804,36176,1.9558823529411764,298.75073221667594
3343,501,24349,37,687,408,926,371,239,1220,88669,1.5523012552301256,441.3184791055095
3344,788,24349,300,833,349,906,49,73,244,3577,0.6712328767123288,87.92041856133307
3345,396,6520,45,522,838,1243,793,721,3028,571753,1.0998613037447988,1071.7695647852668
3346,1221,6520,35,534,989,1247,954,713,3334,680202,1.3380084151472649,1191.0016792599413
3347,986,6520,92,571,782,1181,690,610,2600,420900,1.1311475409836065,920.97774131626
3348,1138,28850,286,397,417,554,131,157,576,20567,0.8343949044585988,204.47493733951845
3349,806,28850,44,369,421,605,377,236,1226,88972,1.597457627118644,444.7752241301217
3350,252,28850,280,411,416,504,136,93,458,12648,1.4623655913978495,164.7573974060042
3351,886,34483,202,1254,521,1611,319,357,1352,113883,0.8935574229691877,478.75881192934713
3352,169,34483,147,1188,516,1605,369,417,1572,153873,0.8848920863309353,556.8213357981176
3353,506,34483,211,1236,518,1587,307,351,1316,107757,0.8746438746438746,466.31534394656154
3354,1698,34483,214,1236,509,1610,295,374,1338,110330,0.7887700534759359,476.3412642213563
3355,1704,34483,56,1182,691,1608,635,426,2122,270510,1.4906103286384975,764.6574396420923
3356,615,34483,208,1255,525,1592,317,337,1308,106829,0.940652818991098,462.66402496844296
3357,998,25296,245,364,583,696,338,332,1340,112216,1.0180722891566265,473.7805399127322
3358,501,25296,216,317,693,753,477,436,1826,207972,1.0940366972477065,646.2391198310421
3359,119,25296,250,337,672,721,422,384,1612,162048,1.0989583333333333,570.5611273124028
3360,1671,28072,50,856,75,870,25,14,78,350,1.7857142857142858,28.653097563788805
3361,39,28072,52,857,73,870,21,13,68,273,1.6153846153846154,24.698178070456937
3362,1198,28072,53,857,73,869,20,12,64,240,1.6666666666666667,23.323807579381203
3363,44,28072,51,857,73,869,22,12,68,264,1.8333333333333333,25.059928172283335
3364,818,28072,52,854,73,870,21,16,74,336,1.3125,26.40075756488817
3365,1673,28072,54,862,71,868,17,6,46,102,2.833333333333333,18.027756377319946
3366,1556,28072,52,856,74,870,22,14,72,308,1.5714285714285714,26.076809620810597
3367,485,28072,51,857,74,868,23,11,68,253,2.090909090909091,25.495097567963924
3368,962,28072,52,859,74,871,22,12,68,264,1.8333333333333333,25.059928172283335
3369,1206,28072,52,856,67,869,15,13,56,195,1.1538461538461535,19.849433241279208
3370,809,5681,36,555,159,632,123,77,400,9471,1.5974025974025974,145.11374848717816
3371,137,5681,32,554,158,619,126,65,382,8190,1.9384615384615385,141.77799547179387
3372,865,5681,37,573,110,612,73,39,224,2847,1.871794871794872,82.76472678623425
3373,1508,5681,34,573,57,604,23,31,108,713,0.7419354838709677,38.600518131237564
3374,149,5681,39,565,158,621,119,56,350,6664,2.125,131.51805959639154
3375,285,33138,62,458,855,1114,793,656,2898,520208,1.208841463414634,1029.1671390012411
3376,58,33138,61,449,874,1098,813,649,2924,527637,1.2526964560862863,1040.2740023666843
3377,884,33138,69,423,856,1112,787,689,2952,542243,1.1422351233671988,1045.987571627885
3378,477,3895,69,211,762,697,693,486,2358,336798,1.4259259259259258,846.4307414077067
3379,852,3895,13,188,748,697,735,509,2488,374115,1.4440078585461689,894.0391490309582
3380,948,3895,21,195,756,662,735,467,2404,343245,1.5738758029978586,870.8122644979227
3381,1083,22657,84,547,831,1328,747,781,3056,583407,0.9564660691421256,1080.7266074266886
3382,1682,22657,24,523,835,1308,811,785,3192,636635,1.0331210191082802,1128.6921635237838
3383,55,22657,143,531,752,1328,609,797,2812,485373,0.7641154328732748,1003.0403780506546
3384,372,22657,239,746,727,1249,488,503,1982,245464,0.9701789264413518,700.8230875192397
3385,1406,22657,111,575,752,1316,641,741,2764,474981,0.8650472334682859,979.7765051275725
3386,1157,22657,175,571,728,1340,553,769,2644,425257,0.7191157347204161,947.1905827234559
3387,1163,22657,60,531,820,1316,760,785,3090,596600,0.9681528662420382,1092.62299078868
3388,886,30633,80,1346,605,1687,525,341,1732,179025,1.5395894428152492,626.0239612027642
3389,1046,30633,275,1414,560,1508,285,94,758,26790,3.0319148936170213,300.1016494456503
3390,1706,30633,119,1297,601,1724,482,427,1818,205814,1.1288056206088992,643.9355557817878
3391,118,30633,74,1324,628,1692,554,368,1844,203872,1.5054347826086956,665.0864605447927
3392,621,30633,422,1360,584,1574,162,214,752,34668,0.7570093457943925,268.4026825499328
3393,1477,30633,82,1321,595,1718,513,397,1820,203661,1.292191435768262,648.6740321609923
3394,391,30633,94,1333,593,1560,499,227,1452,113273,2.198237885462555,548.2061655983084
3395,922,30633,100,1345,561,1668,461,323,1568,148903,1.4272445820433437,562.8943062422998
3396,651,15912,38,658,53,667,15,9,48,135,1.6666666666666667,17.4928556845359
3397,909,15912,38,656,54,669,16,13,58,208,1.2307692307692308,20.615528128088304
3398,857,15912,40,657,50,667,10,10,40,100,1.0,14.142135623730951
3399,88,15912,40,658,53,667,13,9,44,117,1.4444444444444444,15.811388300841896
3400,203,15912,39,657,55,668,16,11,54,176,1.4545454545454546,19.4164878389476
3401,1353,5568,105,747,328,885,223,138,722,30774,1.615942028985507,262.24606765402604
3402,313,5568,54,707,311,882,257,175,864,44975,1.4685714285714286,310.92442811718735
3403,208,5568,84,755,357,881,273,126,798,34398,2.1666666666666665,300.6742423288034
3404,1097,5568,76,754,298,883,222,129,702,28638,1.7209302325581397,256.7586415293554
3405,1525,5568,76,733,350,878,274,145,838,39730,1.889655172413793,310.0016128990299
3406,255,31479,42,559,628,1026,586,467,2106,273662,1.2548179871520342,749.3230278057655
3407,134,31479,18,510,555,1052,537,542,2158,291054,0.9907749077490776,762.9764085474727
3408,1508,31479,32,566,656,1066,624,500,2248,312000,1.248,799.6099048911287
3409,1196,31479,31,534,610,1057,579,523,2204,302817,1.1070745697896751,780.237143437814
3410,697,31479,31,561,540,1124,509,563,2144,286567,0.9040852575488456,758.9795781178832
3411,1675,31479,20,573,635,1041,615,468,2166,287820,1.314102564102564,772.8188662293384
3412,762,31479,23,621,583,1069,560,448,2016,250880,1.25,717.149914592479
3413,32,31479,43,632,699,1056,656,424,2160,278144,1.5471698113207548,781.0966649525525
3414,761,31479,259,621,583,962,324,341,1330,110484,0.9501466275659824,470.37963391286405
3415,265,8200,135,276,741,832,606,556,2324,336936,1.0899280575539572,822.4183850085064
3416,375,8200,107,275,772,791,665,516,2362,343140,1.2887596899224807,841.7131340308288
3417,161,8200,135,303,729,745,594,442,2072,262548,1.3438914027149322,740.4052944165107
3418,866,8200,242,328,480,605,238,277,1030,65926,0.8592057761732852,365.20268345125834
3419,1361,8200,176,281,690,767,514,486,2000,249804,1.0576131687242798,707.3839127376308
3420,1686,8200,119,307,679,748,560,441,2002,246960,1.2698412698412698,712.7980078535574
3421,47,8200,144,330,618,784,474,454,1856,215196,1.0440528634361232,656.3474689522311
3422,1031,8200,116,288,715,783,599,495,2188,296505,1.21010101010101,777.0624170554127
3423,1084,8200,237,320,513,619,276,299,1150,82524,0.9230769230769232,406.91153829794507
3424,213,8200,85,301,731,772,646,471,2234,304266,1.3715498938428874,799.4729513873499
3425,1685,8200,217,313,674,723,457,410,1734,187370,1.1146341463414635,613.9617251913999
3426,134,25426,41,399,810,844,769,445,2428,342205,1.7280898876404494,888.4739726069639
3427,258,25426,99,407,450,892,351,485,1672,170235,0.7237113402061855,598.686896465924
3428,805,25426,108,422,378,604,270,182,904,49140,1.4835164835164836,325.613267542955
3429,247,25426,122,414,334,606,212,192,808,40704,1.1041666666666667,286.0209782515961
3430,1732,25426,39,384,835,907,796,523,2638,416308,1.5219885277246654,952.4415992595032
3431,1024,25426,62,398,466,924,404,526,1860,212504,0.7680608365019012,663.243545011936
3432,119,22412,92,882,612,1204,520,322,1684,167440,1.6149068322981366,611.6240675447623
3433,1222,22412,59,882,576,1222,517,340,1714,175780,1.5205882352941176,618.7802517857208
3434,110,22412,101,914,645,1188,544,274,1636,149056,1.9854014598540144,609.1075438705385
3435,217,22412,32,870,611,1182,579,312,1782,180648,1.8557692307692308,657.7119430267327
3436,1595,22412,105,885,356,1120,251,235,972,58985,1.0680851063829788,343.8400791065521
3437,259,18822,79,775,725,1255,646,480,2252,310080,1.3458333333333334,804.8080516495843
3438,551,18822,66,727,721,1258,655,531,2372,347805,1.2335216572504708,843.1998576849975
3439,1033,18822,247,1009,703,1257,456,248,1408,113088,1.8387096774193548,519.0761023202667
3440,606,18822,291,1032,571,1231,280,199,958,55720,1.407035175879397,343.5127362995439
3441,774,18822,80,726,715,1264,635,538,2346,341630,1.1802973977695168,832.2673849190535
3442,1097,18822,39,721,716,1250,677,529,2412,358133,1.279773156899811,859.1682023911267
3443,1408,34143,139,669,477,956,338,287,1250,97006,1.1777003484320558,443.41064488800896
3444,1222,34143,270,622,433,862,163,240,806,39120,0.6791666666666667,290.11894112587686
3445,1046,34143,204,662,480,889,276,227,1006,62652,1.2158590308370043,357.3583635512117
3446,929,34143,63,612,479,887,416,275,1382,114400,1.5127272727272727,498.6792556343205
3447,1529,34143,78,587,571,921,493,334,1654,164662,1.4760479041916168,595.4871954962592
3448,391,34143,59,627,567,929,508,302,1620,153416,1.6821192052980132,590.9890015897081
3449,169,34143,84,600,505,960,421,360,1562,151560,1.1694444444444445,553.9323063335447
3450,1195,146,51,226,542,545,491,319,1620,156629,1.5391849529780564,585.527112950374
3451,1383,146,83,231,506,528,423,297,1440,125631,1.4242424242424243,516.8539445530042
3452,422,146,17,250,535,534,518,284,1604,147112,1.823943661971831,590.7452919829324
3453,1725,146,70,211,529,569,459,358,1634,164322,1.2821229050279328,582.1039426081909
3454,1629,16002,119,708,781,1111,662,403,2130,266786,1.6426799007444168,775.0180643056005
3455,1584,16002,48,513,828,1115,780,602,2764,469560,1.2956810631229236,985.2938647936462
3456,1509,16002,99,568,779,1038,680,470,2300,319600,1.4468085106382982,826.6196223173026
3457,106,16002,121,587,782,1108,661,521,2364,344381,1.268714011516315,841.6424418956069
3458,1681,16002,53,534,818,1102,765,568,2666,434520,1.3468309859154928,952.8111040494857
3459,552,16002,116,542,797,1092,681,550,2462,374550,1.2381818181818185,875.363353128288
3460,361,6822,357,542,702,1103,345,561,1812,193545,0.6149732620320856,658.5939568505013
3461,1203,6822,317,575,696,1120,379,545,1848,206555,0.6954128440366972,663.8267846358717
3462,1389,6822,284,547,685,1157,401,610,2022,244610,0.6573770491803279,730.0006849311856
3463,195,6822,348,601,667,1120,319,519,1676,165561,0.6146435452793835,609.1978332200468
3464,482,6822,422,576,681,1099,259,523,1564,135457,0.4952198852772466,583.6180257668537
3465,1340,6822,490,606,622,791,132,185,634,24420,0.7135135135135136,227.26416347501865
3466,525,22928,253,1167,718,1607,465,440,1810,204600,1.056818181818182,640.1757571167468
3467,1188,22928,101,1194,741,1607,640,413,2106,264320,1.5496368038740918,761.6882564409143
3468,15,22928,40,1246,755,1623,715,377,2184,269555,1.8965517241379308,808.3031609489103
3469,1182,22928,315,1240,752,1589,437,349,1572,152513,1.2521489971346704,559.2584375760458
3470,330,22928,84,1192,781,1677,697,485,2364,338045,1.4371134020618557,849.1372091717569
3471,126,11365,272,501,454,785,182,284,932,51688,0.6408450704225352,337.31291110777244
3472,952,11365,350,586,383,654,33,68,202,2244,0.4852941176470588,75.58438992278762
3473,1002,11365,432,507,435,510,3,3,12,9,1.0,4.242640687119285
3474,337,11365,250,537,643,777,393,240,1266,94320,1.6375,460.4877848542782
3475,1282,11365,220,564,505,776,285,212,994,60420,1.3443396226415094,355.2027589982938
3476,238,11365,286,507,424,689,138,182,640,25116,0.7582417582417582,228.40315234251912
3477,629,11365,215,447,503,789,288,342,1260,98496,0.8421052631578947,447.11072454147194
3478,421,11365,223,484,640,781,417,297,1428,123849,1.404040404040404,511.9550761541485
3479,1182,11365,253,537,536,786,283,249,1064,70467,1.1365461847389555,376.9482723133242
3480,1003,11365,217,522,647,786,430,264,1388,113520,1.6287878787878791,504.57506874596965
3481,1454,25720,110,465,211,594,101,129,460,13029,0.7829457364341085,163.835283135227
3482,592,25720,51,416,249,595,198,179,754,35442,1.106145251396648,266.9175902783479
3483,581,25720,97,448,197,592,100,144,488,14400,0.6944444444444444,175.31685600648902
3484,1508,25720,152,450,229,584,77,134,422,10318,0.5746268656716418,154.5477272560163
3485,1387,25720,91,501,158,595,67,94,322,6298,0.7127659574468085,115.43396380615195
3486,247,25720,110,513,152,555,42,42,168,1764,1.0,59.39696961966999
3487,1732,25720,78,450,216,580,138,130,536,17940,1.0615384615384615,189.58902921846507
3488,134,25720,204,526,221,552,17,26,86,442,0.6538461538461539,31.064449134018133
3489,359,25720,94,466,255,585,161,119,560,19159,1.3529411764705883,200.20489504505127
3490,228,3301,57,1013,178,1100,121,87,416,10527,1.3908045977011494,149.03019828209315
3491,1107,3301,83,1031,154,1090,71,59,260,4189,1.2033898305084745,92.31467922275417
3492,1116,3301,67,1018,163,1093,96,75,342,7200,1.28,121.82364302548172
3493,1262,3301,56,1013,187,1096,131,83,428,10873,1.5783132530120485,155.08062419270823
3494,62,3301,57,1015,181,1099,124,84,416,10416,1.4761904761904765,149.77316181479245
3495,1682,2874,12,239,940,685,928,446,2748,413888,2.080717488789237,1029.6115772464877
3496,1397,2874,26,279,872,581,846,302,2296,255492,2.8013245033112586,898.2872591771521
3497,1465,2874,20,177,859,317,839,140,1958,117460,5.992857142857143,850.6003762049486
3498,1693,2874,23,191,914,655,891,464,2710,413424,1.9202586206896552,1004.5780208624913
3499,601,2874,114,200,904,676,790,476,2532,376040,1.6596638655462186,922.3209853407868
3500,1259,2874,8,164,906,680,898,516,2828,463368,1.7403100775193798,1035.6930047074761
3501,1245,2874,171,249,828,503,657,254,1822,166878,2.5866141732283463,704.389806854131
3502,1407,2874,110,267,474,490,364,223,1174,81172,1.6322869955156951,426.8782027698299
3503,54,2874,19,246,912,679,893,433,2652,386669,2.0623556581986144,992.4404264236721
3504,712,7683,95,441,381,693,286,252,1076,72072,1.1349206349206349,381.18237105091833
3505,161,7683,83,428,383,701,300,273,1146,81900,1.0989010989010992,405.62174497923553
3506,1361,7683,80,446,342,638,262,192,908,50304,1.3645833333333333,324.8199501262199
3507,1628,7683,91,441,386,701,295,260,1110,76700,1.1346153846153846,393.2238548206352
3508,875,7683,97,443,355,683,258,240,996,61920,1.075,352.36912464062453
3509,166,7683,79,433,365,646,286,213,998,60918,1.3427230046948355,356.6020190632689
3510,1160,7683,59,444,373,690,314,246,1120,77244,1.2764227642276422,398.88845558627037
3511,325,12448,149,558,865,1069,716,511,2454,365876,1.401174168297456,879.6459515054906
3512,1219,12448,165,565,788,989,623,424,2094,264152,1.4693396226415094,753.5947186651456
3513,1599,12448,44,546,874,1014,830,468,2596,388440,1.7735042735042734,952.8504604606119
3514,1065,5620,38,656,40,667,2,11,26,22,0.18181818181818185,11.180339887498949
3515,809,5620,38,652,57,680,19,28,94,532,0.6785714285714286,33.83784863137726
3516,819,5620,35,653,56,675,21,22,86,462,0.9545454545454546,30.4138126514911
3517,969,5620,42,660,51,668,9,8,34,72,1.125,12.041594578792296
3518,1508,5620,35,670,52,676,17,6,46,102,2.833333333333333,18.027756377319946
3519,137,5620,36,653,57,678,21,25,92,525,0.84,32.64965543462902
3520,701,5620,36,654,63,676,27,22,98,594,1.2272727272727273,34.828149534535996
3521,528,5620,44,652,50,659,6,7,26,42,0.8571428571428571,9.219544457292887
3522,1574,5620,36,653,53,676,17,23,80,391,0.7391304347826086,28.600699292150182
3523,967,5620,38,655,55,677,17,22,78,374,0.7727272727272727,27.80287754891569
3524,752,23164,52,422,275,602,223,180,806,40140,1.2388888888888892,286.58157651879856
3525,952,23164,156,452,179,453,23,1,48,23,23.0,23.021728866442675
3526,472,23164,73,435,234,580,161,145,612,23345,1.1103448275862071,216.6702563805194
3527,1182,23164,142,438,233,560,91,122,426,11102,0.7459016393442623,152.2005256232711
3528,576,23164,117,445,209,591,92,146,476,13432,0.6301369863013698,172.5688268488837
3529,682,23164,79,428,239,599,160,171,662,27360,0.935672514619883,234.1815535006974
3530,636,23164,76,419,253,602,177,183,720,32391,0.9672131147540984,254.5937941113255
3531,1549,23164,73,431,233,591,160,160,640,25600,1.0,226.27416997969522
3532,525,23164,144,436,205,567,61,131,384,7991,0.4656488549618321,144.5060552364502
3533,68,23164,61,425,275,590,214,165,758,35310,1.2969696969696969,270.22398117117586
3534,27,23164,122,435,239,591,117,156,546,18252,0.75,195.0
3535,335,31954,459,815,806,1176,347,361,1416,125267,0.961218836565097,500.729467876617
3536,689,31954,251,783,954,1229,703,446,2298,313538,1.5762331838565022,832.5412902673356
3537,577,31954,326,839,952,1226,626,387,2026,242262,1.6175710594315245,735.9653524453444
3538,947,31954,306,864,940,1197,634,333,1934,211122,1.903903903903904,716.1319710779571
3539,957,31954,363,814,867,1185,504,371,1750,186984,1.3584905660377358,625.8250554268341
3540,1156,20552,56,759,437,959,381,200,1162,76200,1.905,430.30338134855504
3541,1302,20552,77,750,383,950,306,200,1012,61200,1.53,365.5625801418958
3542,1623,20552,48,726,478,1011,430,285,1430,122550,1.5087719298245614,515.8730463980455
3543,1158,20552,48,713,483,997,435,284,1438,123540,1.5316901408450705,519.5007218474292
3544,1521,20552,41,715,492,1006,451,291,1484,131241,1.549828178694158,536.7327081518323
3545,157,20552,33,722,448,969,415,247,1324,102505,1.680161943319838,482.94306082601497
3546,919,20552,35,710,347,1007,312,297,1218,92664,1.0505050505050506,430.758633111398
3547,981,20552,40,733,486,959,446,226,1344,100796,1.9734513274336285,499.991999935999
3548,160,20552,35,715,485,998,450,283,1466,127350,1.5901060070671378,531.5910082008536
3549,421,8280,615,483,959,954,344,471,1630,162024,0.7303609341825902,583.2469459842889
3550,1001,8280,61,476,580,932,519,456,1950,236664,1.138157894736842,690.8668467946627
3551,1373,8280,721,567,886,720,165,153,636,25245,1.0784313725490196,225.01999911119012
3552,25,8280,659,543,897,845,238,302,1080,71876,0.7880794701986755,384.51007789133433
3553,291,8280,598,467,961,926,363,459,1644,166617,0.7908496732026143,585.1922760939348
3554,341,8280,569,479,922,711,353,232,1170,81896,1.5215517241379308,422.4133047147071
3555,1430,8280,325,605,918,874,593,269,1724,159517,2.204460966542751,651.160502487674
3556,124,8280,247,437,953,1017,706,580,2572,409480,1.217241379310345,913.6936029107351
3557,1661,8280,252,546,874,978,622,432,2108,268704,1.4398148148148149,757.3031097255576
3558,846,8280,56,496,962,1028,906,532,2876,481992,1.7030075187969924,1050.6474194514542
3559,1383,1748,111,518,470,713,359,195,1108,70005,1.841025641025641,408.54130758100825
3560,141,1748,121,523,506,725,385,202,1174,77770,1.9059405940594056,434.77465427506235
3561,1616,1748,117,515,474,771,357,256,1226,91392,1.39453125,439.30058046854435
3562,1565,1748,91,512,503,744,412,232,1288,95584,1.7758620689655171,472.8297790960294
3563,1573,1748,174,548,432,675,258,127,770,32766,2.031496062992126,287.563905940923
3564,1508,1748,138,489,286,719,148,230,756,34040,0.6434782608695652,273.5031992500271
3565,1028,26121,22,328,436,617,414,289,1406,119646,1.4325259515570934,504.8930579835694
3566,656,26121,58,357,417,597,359,240,1198,86160,1.4958333333333331,431.83445902336234
3567,1030,26121,251,363,442,506,191,143,668,27313,1.3356643356643356,238.60008382228202
3568,1401,26121,316,359,406,509,90,150,480,13500,0.6,174.92855684535903
3569,1680,26121,21,343,445,602,424,259,1366,109816,1.6370656370656371,496.84705896281605
3570,1307,26121,58,361,445,538,387,177,1128,68499,2.1864406779661016,425.55610675914403
3571,1085,26121,36,327,448,623,412,296,1416,121952,1.391891891891892,507.30661340061397
3572,692,4592,50,909,58,918,8,9,34,72,0.8888888888888888,12.041594578792296
3573,1508,4592,50,908,56,914,6,6,24,36,1.0,8.48528137423857
3574,294,4592,50,908,60,918,10,10,40,100,1.0,14.142135623730951
3575,1389,4592,50,908,60,918,10,10,40,100,1.0,14.142135623730951
3576,42,4592,50,908,60,918,10,10,40,100,1.0,14.142135623730951
3577,663,34652,118,882,633,1516,515,634,2298,326510,0.8123028391167192,816.8114837586455
3578,1351,34652,144,922,658,1499,514,577,2182,296578,0.8908145580589255,772.7386362800814
3579,918,34652,171,939,628,1453,457,514,1942,234898,0.8891050583657587,687.782669162287
3580,1312,6254,42,628,210,709,168,81,498,13608,2.074074074074074,186.50737250843463
3581,1473,6254,57,633,201,701,144,68,424,9792,2.117647058823529,159.24823389915505
3582,1045,6254,104,625,207,693,103,68,342,7004,1.5147058823529411,123.42204017111368
3583,379,29284,51,1370,59,1379,8,9,34,72,0.8888888888888888,12.041594578792296
3584,1585,29284,51,1370,59,1379,8,9,34,72,0.8888888888888888,12.041594578792296
3585,1165,29284,50,1370,59,1380,9,10,38,90,0.9,13.45362404707371
3586,1097,5747,24,402,374,686,350,284,1268,99400,1.2323943661971828,450.7282995331001
3587,1353,5747,25,399,409,691,384,292,1352,112128,1.3150684931506849,482.4106134819175
3588,1399,5747,120,465,353,634,233,169,804,39377,1.3786982248520712,287.8367592924851
3589,1627,5747,173,513,355,682,182,169,702,30758,1.0769230769230769,248.3646512690564
3590,1694,5747,150,416,383,686,233,270,1006,62910,0.8629629629629629,356.6356684348889
3591,1738,5747,129,462,409,689,280,227,1014,63560,1.2334801762114538,360.45665481441733
3592,208,5747,19,403,409,689,390,286,1352,111540,1.3636363636363635,483.62795618119515
3593,1222,30935,197,460,670,869,473,409,1764,193457,1.156479217603912,625.3079241461761
3594,457,30935,178,555,659,889,481,334,1630,160654,1.440119760479042,585.5911543047761
3595,1706,30935,167,542,603,877,436,335,1542,146060,1.3014925373134327,549.8372486472701
3596,329,30935,129,548,638,871,509,323,1664,164407,1.5758513931888545,602.8349691250501
3597,936,30935,203,544,700,881,497,337,1668,167489,1.4747774480712166,600.4814734860685
3598,108,432,113,846,115,849,2,3,10,6,0.6666666666666666,3.605551275463989
3599,886,432,52,840,296,1036,244,196,880,47824,1.2448979591836735,312.9728422722969
3600,60,432,56,849,298,1013,242,164,812,39688,1.4756097560975612,292.33542378576016
3601,379,32282,50,634,127,679,77,45,244,3465,1.7111111111111108,89.1852005660132
3602,155,32282,46,626,124,679,78,53,262,4134,1.4716981132075468,94.30270409696638
3603,872,32282,41,630,99,679,58,49,214,2842,1.1836734693877549,75.92759709091287
3604,391,13921,104,866,516,1075,412,209,1242,86108,1.971291866028708,461.9794367718113
3605,1046,13921,125,838,507,1082,382,244,1252,93208,1.5655737704918034,453.27695727888045
3606,1170,13921,96,806,488,1166,392,360,1504,141120,1.0888888888888888,532.2255161113567
3607,343,8358,27,391,36,398,9,7,32,63,1.2857142857142858,11.40175425099138
3608,1373,8358,29,391,34,396,5,5,20,25,1.0,7.0710678118654755
3609,1661,8358,27,392,36,396,9,4,26,36,2.25,9.848857801796104
3610,291,8358,29,391,35,397,6,6,24,36,1.0,8.48528137423857
3611,421,8358,28,391,35,396,7,5,24,35,1.4,8.602325267042627
3612,1361,33300,463,391,969,1258,506,867,2746,438702,0.5836216839677048,1003.855069220652
3613,656,33300,480,461,971,1159,491,698,2378,342718,0.7034383954154728,853.3961565416146
3614,1513,33300,387,432,992,1182,605,750,2710,453750,0.8066666666666666,963.6000207554999
