,userId,itemId,Xmin,Ymin,Xmax,Ymax,L,H,P,S,L/H,D
0,1164,6132,62,656,276,803,214,147,722,31458,1.45578231292517,259.6247291765559
1,1399,6132,184,662,235,740,51,78,258,3978,0.6538461538461539,93.1933474020544
2,1694,6132,63,648,272,830,209,182,782,38038,1.1483516483516485,277.1371501621535
3,916,6132,111,637,253,831,142,194,672,27548,0.7319587628865979,240.41630560342617
4,1621,6132,60,651,242,819,182,168,700,30576,1.0833333333333333,247.68528418135784
5,1092,6132,39,649,249,825,210,176,772,36960,1.193181818181818,274.0
6,301,31297,29,393,126,487,97,94,382,9118,1.0319148936170213,135.07405376311175
7,1508,31297,25,399,120,485,95,86,362,8170,1.1046511627906976,128.14444974324874
8,535,31297,25,399,108,472,83,73,312,6059,1.1369863013698631,110.5350623105628
9,254,18168,209,739,534,1051,325,312,1274,101400,1.0416666666666667,450.5208097302499
10,1147,18168,243,719,479,977,236,258,988,60888,0.9147286821705426,349.6569747624091
11,246,18168,159,718,587,1074,428,356,1568,152368,1.2022471910112358,556.7045895266178
12,29,8398,53,1020,61,1027,8,7,30,56,1.1428571428571428,10.63014581273465
13,421,8398,54,1020,61,1028,7,8,30,56,0.875,10.63014581273465
14,1050,8398,53,1019,61,1028,8,9,34,72,0.8888888888888888,12.041594578792296
15,154,8774,116,959,795,1300,679,341,2040,231539,1.991202346041056,759.8170832509625
16,866,8774,308,1044,755,1317,447,273,1440,122031,1.637362637362637,523.7728515301266
17,311,8774,288,967,296,975,8,8,32,64,1.0,11.313708498984761
18,1651,2722,21,324,305,507,284,183,934,51972,1.5519125683060109,337.85351855500926
19,950,2722,65,322,328,473,263,151,828,39713,1.7417218543046358,303.2655601943617
20,577,2722,22,318,312,507,290,189,958,54810,1.5343915343915344,346.15170084805305
21,1585,29286,42,605,118,691,76,86,324,6536,0.8837209302325582,114.76933388322858
22,379,29286,35,598,120,681,85,83,336,7055,1.0240963855421688,118.80235687897779
23,1165,29286,96,602,97,603,1,1,4,1,1.0,1.4142135623730951
24,857,3135,116,171,552,575,436,404,1680,176144,1.0792079207920793,594.4005383577643
25,356,3135,101,156,564,592,463,436,1798,201868,1.061926605504587,635.9756284638587
26,903,3135,105,173,476,478,371,305,1352,113155,1.2163934426229508,480.2770034053265
27,1496,30215,63,368,235,548,172,180,704,30960,0.9555555555555556,248.96586111352696
28,1508,30215,38,326,220,554,182,228,820,41496,0.7982456140350878,291.73275441746335
29,590,30215,61,357,197,479,136,122,516,16592,1.1147540983606556,182.70194306574848
30,491,30215,50,330,239,554,189,224,826,42336,0.84375,293.0818998164165
31,483,30215,52,327,218,556,166,229,790,38014,0.7248908296943232,282.83740912404073
32,1453,30215,49,361,228,545,179,184,726,32936,0.9728260869565216,256.7041098229633
33,147,30215,47,320,239,548,192,228,840,43776,0.8421052631578947,298.0738163609813
34,145,30215,61,345,179,509,118,164,564,19352,0.7195121951219512,202.03960007879644
35,904,30215,36,339,227,539,191,200,782,38200,0.955,276.55198426335687
36,1041,33357,56,899,220,1060,164,161,650,26404,1.0186335403726707,229.8194943863553
37,1411,33357,53,904,258,1069,205,165,740,33825,1.2424242424242424,263.1539473388153
38,937,33357,48,911,212,1064,164,153,634,25092,1.0718954248366013,224.28776159211185
39,660,10766,6,255,404,725,398,470,1736,187060,0.8468085106382979,615.8766110187981
40,917,10766,94,214,448,689,354,475,1658,168150,0.7452631578947368,592.4027346324458
41,1743,10766,60,172,479,635,419,463,1764,193997,0.9049676025917928,624.4437524709491
42,831,11109,47,609,920,1102,873,493,2732,430389,1.77079107505071,1002.5856571884519
43,820,11109,99,718,924,1031,825,313,2276,258225,2.635782747603834,882.3797368480308
44,1212,11109,31,603,546,1084,515,481,1992,247715,1.0706860706860706,704.6885837020492
45,917,11109,79,687,935,1048,856,361,2434,309016,2.3711911357340716,929.0086113702068
46,1576,11109,76,667,924,1124,848,457,2610,387536,1.8555798687089715,963.303171384793
47,1405,11109,75,656,919,1043,844,387,2462,326628,2.1808785529715764,928.4960958453191
48,1743,11109,58,593,481,1082,423,489,1824,206847,0.8650306748466258,646.5678618675691
49,1003,13110,43,469,515,835,472,366,1676,172752,1.289617486338798,597.2771550963589
50,1282,13110,46,435,652,922,606,487,2186,295122,1.2443531827515402,777.4348847331203
51,1182,13110,70,516,493,878,423,362,1570,153126,1.1685082872928176,556.7521890392529
52,1602,813,283,1042,624,1432,341,390,1462,132990,0.8743589743589744,518.0550163833954
53,886,813,271,1010,679,1421,408,411,1638,167688,0.9927007299270072,579.1243389808444
54,1168,813,182,1028,740,1457,558,429,1974,239382,1.3006993006993006,703.8501260921959
55,506,35799,52,833,857,1281,805,448,2506,360640,1.796875,921.264891331478
56,886,35799,44,787,866,1286,822,499,2642,410178,1.6472945891783568,961.6054284372567
57,615,35799,47,859,842,1296,795,437,2464,347415,1.8192219679633868,907.1901674952171
58,501,25988,45,855,126,907,81,52,266,4212,1.5576923076923077,96.25487000666512
59,119,25988,47,863,115,898,68,35,206,2380,1.9428571428571428,76.47875521999558
60,1218,25988,63,855,125,913,62,58,240,3596,1.0689655172413792,84.8999411071645
61,1046,25988,85,869,104,891,19,22,82,418,0.8636363636363636,29.068883707497267
62,507,25988,63,858,124,910,61,52,226,3172,1.1730769230769231,80.15609770940699
63,1470,25988,65,863,118,910,53,47,200,2491,1.127659574468085,70.83784299369935
64,1329,20671,44,724,135,795,91,71,324,6461,1.2816901408450705,115.42096863222038
65,120,20671,46,733,129,792,83,59,284,4897,1.4067796610169492,101.83319694480774
66,1182,20671,47,732,118,791,71,59,260,4189,1.2033898305084745,92.31467922275417
67,70,20671,39,724,146,795,107,71,356,7597,1.5070422535211268,128.41339493993607
68,850,20671,45,727,146,796,101,69,340,6969,1.463768115942029,122.31925441237777
69,600,20754,34,291,325,453,291,162,906,47142,1.7962962962962965,333.0540496676178
70,1689,20754,40,352,107,417,67,65,264,4355,1.0307692307692309,93.34880824091971
71,57,20754,37,312,320,453,283,141,848,39903,2.0070921985815597,316.1803282938393
72,1156,20754,36,361,109,415,73,54,254,3942,1.351851851851852,90.80198235721508
73,919,20754,18,305,214,426,196,121,634,23716,1.6198347107438016,230.3410514867031
74,1158,20754,15,283,327,444,312,161,946,50232,1.937888198757764,351.0911562543266
75,91,22331,107,807,336,930,229,123,704,28167,1.8617886178861789,259.9423012901132
76,422,22331,100,799,247,928,147,129,552,18963,1.1395348837209305,195.57607215607945
77,1241,22331,100,812,218,934,118,122,480,14396,0.9672131147540984,169.72919607421701
78,298,22331,118,802,204,901,86,99,370,8514,0.8686868686868687,131.13733259449805
79,488,22331,71,787,333,937,262,150,824,39300,1.7466666666666666,301.90064590855053
80,1562,22331,95,806,325,938,230,132,724,30360,1.7424242424242424,265.18672666632466
81,137,5611,49,801,693,1238,644,437,2162,281428,1.4736842105263157,778.270518521677
82,1073,5611,81,817,687,1258,606,441,2094,267246,1.3741496598639455,749.4778182174573
83,1065,5611,197,943,386,1115,189,172,722,32508,1.0988372093023255,255.54842985234717
84,528,5611,64,807,169,1002,105,195,600,20475,0.5384615384615384,221.472345903501
85,1508,5611,126,808,307,1202,181,394,1150,71314,0.4593908629441624,433.5862082677446
86,149,5611,115,868,691,1253,576,385,1922,221760,1.4961038961038962,692.8210447150116
87,809,5611,97,843,666,1250,569,407,1952,231583,1.3980343980343979,699.5784444935392
88,819,5611,86,811,690,1254,604,443,2094,267572,1.363431151241535,749.042722413081
89,967,5611,143,818,655,1253,512,435,1894,222720,1.1770114942528735,671.8400107168372
90,969,5611,422,990,547,1146,125,156,562,19500,0.8012820512820513,199.90247622278218
91,218,11687,68,697,486,1045,418,348,1532,145464,1.2011494252873562,543.9007262359556
92,1411,11687,106,716,437,1048,331,332,1326,109892,0.9969879518072288,468.81232918941026
93,1469,11687,120,717,394,1049,274,332,1212,90968,0.8253012048192772,430.4648650006177
94,1092,4220,128,542,447,756,319,214,1066,68266,1.4906542056074767,384.1314879048579
95,1255,4220,165,546,435,801,270,255,1050,68850,1.0588235294117647,371.3825520941984
96,152,4220,129,565,443,742,314,177,982,55578,1.7740112994350283,360.4511062543712
97,1752,4220,192,570,320,768,128,198,652,25344,0.6464646464646465,235.77107541002565
98,1467,4220,162,585,435,781,273,196,938,53508,1.3928571428571428,336.0729087564185
99,441,4220,178,554,439,762,261,208,938,54288,1.2548076923076923,333.7439138021846
100,1400,229,107,363,566,755,459,392,1702,179928,1.1709183673469388,603.6099734099827
101,831,229,40,395,596,893,556,498,2108,276888,1.1164658634538152,746.4181133922193
102,1243,229,40,397,518,879,478,482,1920,230396,0.991701244813278,678.8284024700204
103,1287,31168,120,753,205,903,85,150,470,12750,0.5666666666666667,172.40939649566667
104,1142,31168,165,757,200,789,35,32,134,1120,1.09375,47.4236228055175
105,433,31168,120,755,215,907,95,152,494,14440,0.625,179.24564150907548
106,813,31168,106,754,185,901,79,147,452,11613,0.5374149659863946,166.88319268278636
107,207,31168,144,748,212,809,68,61,258,4148,1.1147540983606556,91.35097153287424
108,492,31168,111,752,246,840,135,88,446,11880,1.5340909090909092,161.14899937635357
109,909,31168,146,748,172,836,26,88,228,2288,0.2954545454545455,91.76055797563569
110,1508,31168,93,746,198,907,105,161,532,16905,0.6521739130434783,192.21342304844373
111,535,31168,137,767,203,896,66,129,390,8514,0.5116279069767442,144.90341610879986
112,1263,3775,67,576,276,775,209,199,816,41591,1.050251256281407,288.5862089566998
113,562,3775,88,578,284,782,196,204,800,39984,0.9607843137254902,282.8992753613908
114,1045,3775,94,574,244,755,150,181,662,27150,0.8287292817679558,235.07658326596462
115,1302,20558,176,1112,360,1154,184,42,452,7728,4.380952380952381,188.73261509341728
116,1623,20558,181,1103,340,1184,159,81,480,12879,1.9629629629629632,178.4432682955566
117,919,20558,165,1093,347,1202,182,109,582,19838,1.6697247706422018,212.14381914163798
118,1156,20558,166,1105,333,1169,167,64,462,10688,2.609375,178.84350701101786
119,1158,20558,159,1087,378,1202,219,115,668,25185,1.9043478260869569,247.35804009572846
120,160,20558,172,1089,378,1185,206,96,604,19776,2.145833333333333,227.27076362788065
121,1521,20558,140,1087,379,1187,239,100,678,23900,2.39,259.0772085691831
122,49,20558,157,1064,377,1213,220,149,738,32780,1.4765100671140938,265.7084868798887
123,981,20558,177,1101,326,1176,149,75,448,11175,1.9866666666666664,166.8112706024386
124,1133,6933,102,861,922,1668,820,807,3254,661740,1.0161090458488231,1150.499456757803
125,754,6933,103,795,464,1169,361,374,1470,135014,0.96524064171123,519.8047710438988
126,421,6933,236,822,553,1663,317,841,2316,266597,0.3769322235434007,898.7602572432762
127,1433,6933,222,799,553,1663,331,864,2390,285984,0.3831018518518519,925.2334840460542
128,1281,6933,110,780,526,1675,416,895,2622,372320,0.46480446927374297,986.955419459258
129,577,6933,83,759,625,1699,542,940,2964,509480,0.5765957446808511,1085.06405340883
130,947,6933,115,777,781,1699,666,922,3176,614052,0.7223427331887202,1137.3829610118132
131,952,6933,308,1186,317,1194,9,8,34,72,1.125,12.041594578792296
132,242,25324,64,1035,101,1090,37,55,184,2035,0.6727272727272727,66.2872536767062
133,952,25324,82,1040,97,1082,15,42,114,630,0.35714285714285715,44.598206241955516
134,12,25324,68,1040,98,1093,30,53,166,1590,0.5660377358490566,60.90155991434045
135,639,25324,78,1039,95,1056,17,17,68,289,1.0,24.041630560342615
136,189,25324,60,1035,114,1094,54,59,226,3186,0.9152542372881356,79.98124780221924
137,1554,25324,66,1035,111,1093,45,58,206,2610,0.7758620689655172,73.40980860893181
138,941,25324,81,1036,109,1094,28,58,172,1624,0.4827586206896552,64.40496875241847
139,291,25324,80,1033,109,1077,29,44,146,1276,0.6590909090909091,52.69724850502159
140,957,25324,66,1035,112,1094,46,59,210,2714,0.7796610169491526,74.81310045707235
141,530,24752,199,1094,577,1555,378,461,1678,174258,0.8199566160520607,596.158535961702
142,87,24752,169,1188,610,1546,441,358,1598,157878,1.2318435754189945,568.0184856146849
143,134,24752,200,1116,562,1551,362,435,1594,157470,0.8321839080459771,565.9231396576747
144,258,24752,202,1136,580,1538,378,402,1560,151956,0.9402985074626866,551.8043131400841
145,963,24752,192,1207,565,1487,373,280,1306,104440,1.3321428571428569,466.4000428816447
146,1732,24752,282,1148,487,1446,205,298,1006,61090,0.6879194630872483,361.70291677010295
147,592,24752,62,1077,672,1551,610,474,2168,289140,1.2869198312236287,772.5127830657561
148,805,24752,185,1224,388,1419,203,195,796,39585,1.0410256410256409,281.48534597737057
149,931,4927,586,1264,588,1266,2,2,8,4,1.0,2.8284271247461903
150,221,4927,45,862,608,1254,563,392,1910,220696,1.4362244897959184,686.0269673999703
151,1635,4927,140,863,594,1205,454,342,1592,155268,1.3274853801169588,568.4012667121705
152,505,4927,117,961,556,1230,439,269,1416,118091,1.6319702602230484,514.8611463297653
153,401,4927,52,871,594,1240,542,369,1822,199998,1.4688346883468837,655.6866629724902
154,1601,4927,184,866,472,1158,288,292,1160,84096,0.9863013698630136,410.13168616921075
155,1116,4927,73,859,608,1267,535,408,1886,218280,1.3112745098039216,672.821670281212
156,525,23173,277,503,577,804,300,301,1202,90300,0.9966777408637874,424.97176376790026
157,636,23173,204,528,633,839,429,311,1480,133419,1.3794212218649518,529.8697953271162
158,1182,23173,294,590,575,837,281,247,1056,69407,1.137651821862348,374.1256473432422
159,1728,18756,82,739,679,1143,597,404,2002,241188,1.4777227722772277,720.850192481073
160,699,18756,116,781,598,1106,482,325,1614,156650,1.4830769230769232,581.3338111618831
161,297,18756,64,726,703,1165,639,439,2156,280521,1.4555808656036446,775.2689855785538
162,886,28677,53,508,329,655,276,147,846,40572,1.8775510204081636,312.70593214712125
163,61,28677,76,507,345,652,269,145,828,39005,1.8551724137931036,305.5912302406599
164,1225,28677,50,508,380,637,330,129,918,42570,2.5581395348837206,354.31765409022455
165,955,27107,34,529,574,878,540,349,1778,188460,1.5472779369627507,642.9626738777299
166,744,27107,63,584,295,872,232,288,1040,66816,0.8055555555555556,369.82157860243905
167,79,27107,89,561,542,864,453,303,1512,137259,1.495049504950495,544.993577943814
168,340,27107,53,657,516,850,463,193,1312,89359,2.3989637305699483,501.61539051348893
169,409,27107,75,615,495,870,420,255,1350,107100,1.6470588235294117,491.350180624776
170,421,27107,56,641,311,868,255,227,964,57885,1.1233480176211454,341.40005858230313
171,337,27107,58,620,566,850,508,230,1476,116840,2.208695652173913,557.6414618731286
172,1187,27107,64,650,569,879,505,229,1468,115645,2.205240174672489,554.4961677054225
173,577,27107,62,594,549,864,487,270,1514,131490,1.803703703703704,556.8383966645978
174,1719,27107,93,594,538,849,445,255,1400,113475,1.7450980392156863,512.8840024800929
175,638,27107,49,645,562,864,513,219,1464,112347,2.3424657534246576,557.790283171014
176,330,21822,170,369,823,1134,653,765,2836,499545,0.85359477124183,1005.8001789620043
177,1182,21822,198,612,754,1097,556,485,2082,269660,1.1463917525773195,737.8082406696201
178,853,21822,251,395,807,1090,556,695,2502,386420,0.8,890.034269003166
179,569,18346,667,789,670,791,3,2,10,6,1.5,3.605551275463989
180,416,18346,27,732,711,1136,684,404,2176,276336,1.693069306930693,794.400402819636
181,890,18346,24,732,687,1150,663,418,2162,277134,1.5861244019138756,783.7684607076251
182,1659,18346,261,929,671,1152,410,223,1266,91430,1.8385650224215249,466.7215443923711
183,956,18346,198,783,216,787,18,4,44,72,4.5,18.439088914585774
184,1720,18346,38,731,673,1155,635,424,2118,269240,1.4976415094339623,763.545021593357
185,957,23371,32,471,120,532,88,61,298,5368,1.4426229508196722,107.07474025184464
186,752,23371,30,472,119,530,89,58,294,5162,1.5344827586206895,106.23088063270491
187,636,23371,29,471,119,531,90,60,300,5400,1.5,108.16653826391968
188,283,10521,73,847,315,992,242,145,774,35090,1.668965517241379,282.11522468665174
189,1599,10521,100,868,315,994,215,126,682,27090,1.7063492063492065,249.20072231034965
190,886,10521,55,835,318,995,263,160,846,42080,1.64375,307.8457405909655
191,392,10521,66,850,314,999,248,149,794,36952,1.6644295302013423,289.31816396486414
192,1696,10521,67,837,310,994,243,157,800,38151,1.5477707006369428,289.3060663034911
193,279,35719,182,617,628,767,446,150,1192,66900,2.973333333333333,470.5486159792631
194,1046,35719,152,787,540,886,388,99,974,38412,3.919191919191919,400.4310177795921
195,1704,35719,75,623,635,919,560,296,1712,165760,1.891891891891892,633.4161349381621
196,1408,35719,198,646,536,915,338,269,1214,90922,1.2565055762081785,431.97800869951703
197,615,35719,164,600,576,943,412,343,1510,141316,1.2011661807580174,536.0904774382772
198,506,35719,244,640,550,753,306,113,838,34578,2.707964601769912,326.1977927577071
199,886,35719,245,619,554,761,309,142,902,43878,2.176056338028169,340.06617003165724
200,1602,35719,116,578,642,931,526,353,1758,185678,1.4900849858356942,633.4705991598979
201,119,35719,165,732,572,907,407,175,1164,71225,2.3257142857142856,443.02821580572044
202,1654,32159,142,610,539,1037,397,427,1648,169519,0.9297423887587822,583.0420224992363
203,1281,32159,102,555,858,1304,756,749,3010,566244,1.0093457943925233,1064.2072166641233
204,957,32159,117,553,773,1273,656,720,2752,472320,0.9111111111111112,974.0308003343631
205,947,32159,108,475,856,1304,748,829,3154,620092,0.9022919179734621,1116.5773596128483
206,525,32159,161,561,701,1127,540,566,2212,305640,0.9540636042402828,782.276166069247
207,191,32159,129,653,627,1185,498,532,2060,264936,0.9360902255639098,728.7166801988274
208,934,33084,61,639,319,939,258,300,1116,77400,0.86,395.68169025114116
209,1530,33084,80,680,292,903,212,223,870,47276,0.9506726457399104,307.6897788357618
210,1270,33084,153,781,272,853,119,72,382,8568,1.6527777777777777,139.08630414242805
211,272,33084,63,687,338,939,275,252,1054,69300,1.0912698412698412,373.0
212,7,33084,53,642,346,940,293,298,1182,87314,0.9832214765100672,417.9150631408253
213,58,33084,90,683,298,851,208,168,752,34944,1.238095238095238,267.37239947309445
214,318,33084,75,673,309,897,234,224,916,52416,1.0446428571428572,323.9320916488516
215,884,33084,46,639,381,936,335,297,1264,99495,1.127946127946128,447.69855930078666
216,285,33084,62,662,382,877,320,215,1070,68800,1.4883720930232558,385.5191305240247
217,1500,23728,70,657,279,797,209,140,698,29260,1.4928571428571429,251.55715056424057
218,971,23728,36,595,322,811,286,216,1004,61776,1.3240740740740742,358.40200892294115
219,140,23728,51,630,283,802,232,172,808,39904,1.3488372093023255,288.80443209895515
220,355,19125,72,420,142,541,70,121,382,8470,0.5785123966942148,139.7891269019161
221,817,19125,59,442,162,530,103,88,382,9064,1.1704545454545454,135.47324459095236
222,1663,19125,71,421,192,544,121,123,488,14883,0.9837398373983741,172.53985046939155
223,763,19125,76,430,181,540,105,110,430,11550,0.9545454545454546,152.0690632574555
224,1503,19125,87,440,156,528,69,88,314,6072,0.7840909090909091,111.8257573191436
225,429,19125,93,427,154,526,61,99,320,6039,0.6161616161616161,116.2841347734075
226,1508,142,265,295,623,711,358,416,1548,148928,0.8605769230769231,548.8351300709531
227,1134,142,277,344,615,707,338,363,1402,122694,0.931129476584022,495.99697579723204
228,436,142,227,319,669,702,442,383,1650,169286,1.1540469973890342,584.8529729769697
229,1389,12677,63,812,417,1164,354,352,1412,124608,1.005681818181818,499.2193906490412
230,909,12677,157,828,473,1158,316,330,1292,104280,0.9575757575757576,456.89823812310766
231,963,12677,151,871,400,1166,249,295,1088,73455,0.8440677966101695,386.0388581477259
232,306,6497,78,1208,417,1627,339,419,1516,142041,0.8090692124105012,538.9638206781602
233,1389,6497,78,1199,460,1626,382,427,1618,163114,0.8946135831381733,572.9336785353083
234,195,6497,89,1202,375,1616,286,414,1400,118404,0.6908212560386473,503.1818756672382
235,1540,5067,107,600,715,1422,608,822,2860,499776,0.7396593673965937,1022.422613208452
236,478,5067,128,684,628,1337,500,653,2306,326500,0.7656967840735069,822.4408793341926
237,577,5067,158,691,550,1351,392,660,2104,258720,0.5939393939393941,767.6353300884476
238,521,1811,30,500,73,535,43,35,156,1505,1.2285714285714286,55.44366510251645
239,190,1811,31,499,65,524,34,25,118,850,1.36,42.20189569201838
240,1650,1811,43,509,57,528,14,19,66,266,0.7368421052631579,23.600847442411894
241,518,1811,32,500,71,532,39,32,142,1248,1.21875,50.44799302251776
242,338,1811,32,510,68,522,36,12,96,432,3.0,37.94733192202055
243,952,1811,33,501,63,525,30,24,108,720,1.25,38.41874542459709
244,748,1811,35,501,58,516,23,15,76,345,1.5333333333333334,27.459060435491963
245,744,1811,29,497,72,535,43,38,162,1634,1.131578947368421,57.38466694161429
246,1274,1811,31,498,66,535,35,37,144,1295,0.945945945945946,50.93132631298737
247,831,13695,46,883,325,1006,279,123,804,34317,2.268292682926829,304.9098227345259
248,552,13695,59,887,322,1003,263,116,758,30508,2.2672413793103448,287.4456470360962
249,1308,13695,38,890,321,1010,283,120,806,33960,2.3583333333333334,307.3906309567681
250,161,13695,57,885,322,1008,265,123,776,32595,2.154471544715447,292.15406894308353
251,315,13695,58,882,292,1008,234,126,720,29484,1.8571428571428568,265.7668150842012
252,1739,13855,57,1121,62,1126,5,5,20,25,1.0,7.0710678118654755
253,315,13855,57,1122,62,1126,5,4,18,20,1.25,6.4031242374328485
254,552,13855,56,1121,64,1127,8,6,28,48,1.3333333333333333,10.0
255,523,35648,236,948,886,1321,650,373,2046,242450,1.7426273458445043,749.4191083766145
256,1435,35648,179,962,901,1327,722,365,2174,263530,1.9780821917808218,809.017305130119
257,1425,35648,245,911,891,1334,646,423,2138,273258,1.5271867612293144,772.1690229476964
258,952,35648,227,876,329,964,102,88,380,8976,1.1590909090909092,134.7145129523913
259,191,35648,276,1000,521,1180,245,180,850,44100,1.3611111111111112,304.0148022712052
260,891,35648,32,734,902,1332,870,598,2936,520260,1.4548494983277591,1055.700715165051
261,1420,35648,299,915,883,1309,584,394,1956,230096,1.482233502538071,704.479950034066
262,895,35648,278,921,901,1330,623,409,2064,254807,1.5232273838630808,745.2583444685473
263,631,35648,277,906,890,1341,613,435,2096,266655,1.4091954022988509,751.660827767418
264,1147,18159,140,870,272,1066,132,196,656,25872,0.6734693877551021,236.30488780387088
265,246,18159,124,874,294,1064,170,190,720,32300,0.8947368421052632,254.95097567963924
266,480,18159,127,871,287,1005,160,134,588,21440,1.1940298507462686,208.70074269153906
267,245,18159,151,868,301,1058,150,190,680,28500,0.7894736842105263,242.0743687382041
268,254,18159,129,869,284,1062,155,193,696,29915,0.8031088082901554,247.53585598858197
269,1397,18281,123,820,420,987,297,167,928,49599,1.7784431137724552,340.73156589902266
270,374,18281,166,838,448,964,282,126,816,35532,2.238095238095238,308.86890422961
271,161,18281,140,799,476,1022,336,223,1118,74928,1.506726457399103,403.2679010285842
272,1304,18281,165,881,465,1065,300,184,968,55200,1.6304347826086956,351.93181157718607
273,1622,18281,204,878,411,963,207,85,584,17595,2.4352941176470586,223.77220560203628
274,831,10732,42,534,447,831,405,297,1404,120285,1.3636363636363635,502.2290314189334
275,1743,10732,172,527,420,714,248,187,870,46376,1.3262032085561497,310.60103026229643
276,660,10732,44,545,453,845,409,300,1418,122700,1.3633333333333333,507.22874524222306
277,917,10732,135,532,471,858,336,326,1324,109536,1.0306748466257671,468.15809295578777
278,1212,10732,27,526,471,856,444,330,1548,146520,1.3454545454545457,553.2052060492562
279,450,10732,32,528,466,855,434,327,1522,141918,1.3272171253822629,543.4013249891833
280,1136,14941,27,313,146,411,119,98,434,11662,1.2142857142857142,154.1590088188167
281,1016,14941,44,316,140,402,96,86,364,8256,1.1162790697674418,128.8875478857442
282,970,14941,46,313,156,408,110,95,410,10450,1.1578947368421053,145.34441853748632
283,1723,6090,165,529,398,802,233,273,1012,63609,0.8534798534798534,358.91224554199874
284,137,6090,130,520,401,802,271,282,1106,76422,0.9609929078014184,391.10740212887816
285,1389,6090,141,533,390,798,249,265,1028,65985,0.9396226415094341,363.6289317422364
286,490,6090,206,525,389,775,183,250,866,45750,0.732,309.8209160143969
287,529,6090,128,518,404,801,276,283,1118,78108,0.9752650176678446,395.3036807316623
288,90,6090,220,542,392,805,172,263,870,45236,0.6539923954372624,314.2499005568657
289,1562,6090,193,539,400,788,207,249,912,51543,0.8313253012048193,323.80549717384355
290,1451,6090,199,527,402,801,203,274,954,55622,0.7408759124087592,341.0058650522011
291,149,6090,197,529,352,775,155,246,802,38130,0.6300813008130082,290.7593506664919
292,1340,6090,254,650,293,708,39,58,194,2262,0.6724137931034483,69.8927750200262
293,496,13623,45,612,70,645,25,33,116,825,0.7575757575757576,41.400483088968905
294,831,13623,45,611,73,643,28,32,120,896,0.875,42.5205832509386
295,917,13623,45,613,66,645,21,32,106,672,0.65625,38.27531841800928
296,759,33764,93,977,568,1344,475,367,1684,174325,1.2942779291553133,600.2616096336664
297,648,33764,114,1001,561,1355,447,354,1602,158238,1.2627118644067796,570.1973342624464
298,32,33764,86,1023,584,1332,498,309,1614,153882,1.6116504854368932,586.075933646827
299,1751,27634,105,724,854,1295,749,571,2640,427679,1.3117338003502628,941.8290715411157
300,1078,27634,56,757,857,1245,801,488,2578,390888,1.6413934426229508,937.9472266604342
301,979,27634,73,639,875,1309,802,670,2944,537340,1.1970149253731344,1045.037798359466
302,1158,20710,19,577,868,1071,849,494,2686,419406,1.7186234817813766,982.2611669001275
303,600,20710,39,513,861,1065,822,552,2748,453744,1.4891304347826086,990.1454438616581
304,1464,20710,26,496,816,1070,790,574,2728,453460,1.3763066202090593,976.5121607025691
305,1521,20710,96,598,846,1065,750,467,2434,350250,1.6059957173447537,883.5094792926673
306,1623,20710,114,599,436,1069,322,470,1584,151340,0.6851063829787234,569.7227395847914
307,919,20710,73,621,821,1016,748,395,2286,295460,1.8936708860759492,845.8894726854094
308,981,20710,116,626,852,1066,736,440,2352,323840,1.6727272727272726,857.4940233027867
309,157,20710,37,585,446,1064,409,479,1776,195911,0.8538622129436325,629.8587143161552
310,1114,26881,42,692,292,861,250,169,838,42250,1.4792899408284024,301.7631521574495
311,1268,26881,54,695,276,860,222,165,774,36630,1.3454545454545457,276.6026030246281
312,1311,26881,40,691,296,840,256,149,810,38144,1.7181208053691277,296.2043213729334
313,592,23858,206,1155,519,1541,313,386,1398,120818,0.810880829015544,496.9557324349926
314,140,23858,217,1163,539,1498,322,335,1314,107870,0.9611940298507464,464.66009081908464
315,971,23858,182,1177,539,1545,357,368,1450,131376,0.9701086956521741,512.7114198065028
316,433,31086,33,612,116,654,83,42,250,3486,1.9761904761904765,93.02150289046077
317,1671,31086,38,607,116,655,78,48,252,3744,1.625,91.58602513484249
318,1727,31086,39,611,110,655,71,44,230,3124,1.6136363636363635,83.52843827104634
319,649,31086,37,613,112,653,75,40,230,3000,1.875,85.0
320,909,31086,40,608,73,653,33,45,156,1485,0.7333333333333333,55.80322571321482
321,207,31086,102,611,114,617,12,6,36,72,2.0,13.416407864998739
322,902,16681,55,580,119,635,64,55,238,3520,1.1636363636363636,84.38601779915912
323,813,16681,58,572,123,634,65,62,254,4030,1.0483870967741935,89.8276126811795
324,909,16681,42,573,130,636,88,63,302,5544,1.3968253968253967,108.2266141020775
325,1083,22125,128,840,376,1093,248,253,1002,62744,0.9802371541501976,354.27813931994166
326,1258,22125,68,856,392,1148,324,292,1232,94608,1.1095890410958904,436.16510635308737
327,55,22125,63,783,454,1130,391,347,1476,135677,1.1268011527377522,522.7714605829206
328,1483,23546,93,766,330,908,237,142,758,33654,1.6690140845070425,276.2842738919463
329,1327,23546,77,758,324,907,247,149,792,36803,1.657718120805369,288.4614358974177
330,952,23546,94,761,334,885,240,124,728,29760,1.935483870967742,270.1407040784487
331,15,23546,59,747,330,915,271,168,878,45528,1.613095238095238,318.8494942759044
332,957,23546,51,752,336,916,285,164,898,46740,1.7378048780487805,328.8175786055241
333,106,16073,60,539,623,897,563,358,1842,201554,1.5726256983240223,667.1828834734896
334,1629,16073,334,657,600,929,266,272,1076,72352,0.9779411764705882,380.44710539048657
335,1626,16073,372,690,584,912,212,222,868,47064,0.954954954954955,306.96579614022147
336,1509,16073,54,542,637,932,583,390,1946,227370,1.494871794871795,701.4192754693871
337,1681,16073,43,519,628,923,585,404,1978,236340,1.4480198019801984,710.9437389836132
338,1584,16073,48,516,589,918,541,402,1886,217482,1.3457711442786071,674.0066765247952
339,1249,33275,302,668,688,1088,386,420,1612,162120,0.919047619047619,570.4349217921357
340,1520,33275,502,748,610,1089,108,341,898,36828,0.3167155425219941,357.6940033045005
341,1084,33275,523,690,644,870,121,180,602,21780,0.6722222222222223,216.8893727225933
342,1304,33275,401,689,755,1071,354,382,1472,135228,0.9267015706806284,520.807066004293
343,1578,33275,437,742,752,1110,315,368,1366,115920,0.8559782608695652,484.4058216000299
344,1513,33275,101,650,831,1130,730,480,2420,350400,1.5208333333333333,873.6704184073077
345,656,33275,389,693,692,1078,303,385,1376,116655,0.7870129870129869,489.9326484324146
346,499,33275,343,666,729,1094,386,428,1628,165208,0.9018691588785048,576.3505877501991
347,874,33275,299,712,745,1068,446,356,1604,158776,1.252808988764045,570.6592678648092
348,41,35476,53,958,89,981,36,23,118,828,1.5652173913043481,42.720018726587654
349,94,35476,56,957,89,981,33,24,114,792,1.375,40.80441152620633
350,200,35476,53,957,89,981,36,24,120,864,1.5,43.266615305567875
351,1548,32119,38,580,230,853,192,273,930,52416,0.7032967032967034,333.75589882427545
352,952,32119,68,636,234,803,166,167,666,27722,0.994011976047904,235.46761985462035
353,465,32119,44,636,228,843,184,207,782,38088,0.8888888888888888,276.9566753122228
354,1709,32119,30,631,240,815,210,184,788,38640,1.141304347826087,279.2060171271386
355,191,32119,65,606,235,708,170,102,544,17340,1.6666666666666667,198.25236442474022
356,947,32119,33,622,220,832,187,210,794,39270,0.8904761904761904,281.19210515233175
357,128,32119,30,581,227,863,197,282,958,55554,0.6985815602836879,343.99563950724723
358,592,26046,42,305,277,496,235,191,852,44885,1.2303664921465969,302.8299853052864
359,1508,26046,77,360,241,453,164,93,514,15252,1.7634408602150538,188.53381659532593
360,1387,26046,82,345,220,436,138,91,458,12558,1.5164835164835164,165.3027525481654
361,1346,26046,47,323,93,431,46,108,308,4968,0.4259259259259259,117.38824472663352
362,581,26046,40,345,255,466,215,121,672,26015,1.7768595041322317,246.71035649116962
363,1454,26046,73,340,228,431,155,91,492,14105,1.7032967032967032,179.7386992275175
364,761,26046,74,336,238,452,164,116,560,19024,1.4137931034482758,200.8780724718355
365,1585,35341,32,600,472,1080,440,480,1840,211200,0.9166666666666666,651.1528238439882
366,1512,35341,88,565,456,1092,368,527,1790,193936,0.6982922201138521,642.769787715633
367,1400,35341,233,609,376,817,143,208,702,29744,0.6875,252.41434190631878
368,713,35341,87,553,484,1076,397,523,1840,207631,0.7590822179732314,656.6109959481337
369,828,35341,24,586,329,707,305,121,852,36905,2.520661157024793,328.1249761904753
370,769,35341,37,621,448,1097,411,476,1774,195636,0.8634453781512605,628.8855221739486
371,1684,35341,73,574,453,1050,380,476,1712,180880,0.7983193277310925,609.077991721914
372,495,35341,205,726,213,805,8,79,174,632,0.10126582278481013,79.40403012442127
373,957,31863,148,451,652,857,504,406,1820,204624,1.2413793103448276,647.1877625542684
374,577,31863,210,498,565,793,355,295,1300,104725,1.2033898305084745,461.57339611377085
375,750,31863,124,490,575,806,451,316,1534,142516,1.4272151898734178,550.6877518158543
376,346,31863,133,473,587,832,454,359,1626,162986,1.2646239554317549,578.7892535284324
377,947,31863,212,488,595,831,383,343,1452,131369,1.1166180758017492,514.1381137398782
378,335,31863,180,498,421,734,241,236,954,56876,1.0211864406779658,337.30846416892655
379,1208,21390,135,863,201,915,66,52,236,3432,1.2692307692307692,84.02380615040002
380,966,21390,75,861,232,1000,157,139,592,21823,1.129496402877698,209.69024774652732
381,865,21390,70,847,216,1014,146,167,626,24382,0.8742514970059879,221.82200071228283
382,805,21390,113,843,222,972,109,129,476,14061,0.8449612403100775,168.88457596832222
383,592,21390,32,834,216,1026,184,192,752,35328,0.9583333333333334,265.9323222175146
384,1508,21390,31,938,132,1015,101,77,356,7777,1.3116883116883118,127.00393694685216
385,1662,28464,23,274,443,425,420,151,1142,63420,2.7814569536423845,446.31939236380936
386,252,28464,103,319,411,433,308,114,844,35112,2.701754385964912,328.42046221269464
387,1383,28464,94,295,429,453,335,158,986,52930,2.1202531645569622,370.3903346471125
388,1506,4117,49,663,137,727,88,64,304,5632,1.375,108.81176406988355
389,972,4117,55,662,127,730,72,68,280,4896,1.0588235294117647,99.03534722511958
390,1562,4117,42,661,134,732,92,71,326,6532,1.295774647887324,116.21101496846157
391,1212,11131,57,735,564,1150,507,415,1844,210405,1.2216867469879518,655.1900487644787
392,917,11131,95,727,554,1143,459,416,1750,190944,1.1033653846153846,619.4650918332687
393,831,11131,84,734,539,1133,455,399,1708,181545,1.1403508771929824,605.1660929034276
394,1231,9743,86,527,519,1052,433,525,1916,227325,0.8247619047619048,680.5247974908776
395,421,9743,43,502,511,1056,468,554,2044,259272,0.8447653429602888,725.2172088415994
396,71,9743,83,495,693,1084,610,589,2398,359290,1.035653650254669,847.9510599085303
397,1277,9743,92,541,489,1060,397,519,1832,206043,0.7649325626204239,653.4294147036848
398,1719,9743,69,484,695,1046,626,562,2376,351812,1.113879003558719,841.2609583238723
399,748,9743,28,519,300,888,272,369,1282,100368,0.7371273712737128,458.4157501657202
400,963,12582,230,770,860,1235,630,465,2190,292950,1.3548387096774193,783.0229881682912
401,142,12582,405,766,858,1137,453,371,1648,168063,1.221024258760108,585.533944361896
402,650,12582,192,759,825,1348,633,589,2444,372837,1.0747028862478778,864.6444355918795
403,909,12582,341,754,756,1217,415,463,1756,192145,0.896328293736501,621.7668373273056
404,1668,12582,184,733,873,1214,689,481,2340,331409,1.4324324324324325,840.2868557820002
405,183,8947,241,696,816,1276,575,580,2310,333500,0.9913793103448276,816.7159849054015
406,29,8947,438,787,820,1029,382,242,1248,92444,1.578512396694215,452.203494015692
407,1181,8947,247,730,754,1268,507,538,2090,272766,0.9423791821561338,739.2516486285302
408,287,8947,213,763,773,1244,560,481,2082,269360,1.1642411642411643,738.2147384061091
409,478,8947,86,717,825,1281,739,564,2606,416796,1.3102836879432624,929.6327231762015
410,347,8947,544,829,689,998,145,169,628,24505,0.8579881656804734,222.6791413671249
411,524,8947,167,752,645,1074,478,322,1600,153916,1.484472049689441,576.3401773258568
412,525,8947,235,666,833,1248,598,582,2360,348036,1.0274914089347078,834.4627013833513
413,748,8947,271,851,808,1181,537,330,1734,177210,1.6272727272727272,630.2927891067769
414,1547,8947,253,808,761,1283,508,475,1966,241300,1.0694736842105264,695.4775337852402
415,71,8947,207,739,792,1264,585,525,2220,307125,1.1142857142857143,786.0343503944341
416,492,31229,120,535,571,921,451,386,1674,174086,1.1683937823834196,593.6303563666535
417,535,31229,140,597,525,780,385,183,1136,70455,2.1038251366120218,426.27925119573905
418,1287,31229,129,543,589,929,460,386,1692,177560,1.1917098445595855,600.4964612718379
419,1508,31229,154,500,530,883,376,383,1518,144008,0.9817232375979112,536.716871357702
420,1193,31229,142,517,496,848,354,331,1370,117174,1.0694864048338368,484.6411043236015
421,1142,31229,122,541,478,795,356,254,1220,90424,1.4015748031496065,437.3236787552213
422,1529,34115,61,740,250,881,189,141,660,26649,1.3404255319148937,235.80076335754302
423,1316,34115,40,800,194,878,154,78,464,12012,1.9743589743589745,172.6267650163207
424,929,34115,42,734,253,889,211,155,732,32705,1.3612903225806452,261.8129103004663
425,1222,34115,54,770,195,880,141,110,502,15510,1.2818181818181815,178.83232370016333
426,391,34115,57,741,242,883,185,142,654,26270,1.3028169014084507,233.21449354617735
427,925,34115,51,734,254,885,203,151,708,30653,1.3443708609271523,253.00197627686626
428,119,34115,56,753,246,876,190,123,626,23370,1.5447154471544715,226.33824246026123
429,289,23685,184,623,661,973,477,350,1654,166950,1.3628571428571428,591.6324872756735
430,1010,23685,105,572,680,1041,575,469,2088,269675,1.2260127931769722,742.0148246497505
431,1122,23685,115,571,719,1042,604,471,2150,284484,1.2823779193205944,765.9353758640477
432,917,29236,94,415,484,755,390,340,1460,132600,1.1470588235294117,517.3973328110611
433,314,29236,508,740,510,743,2,3,10,6,0.6666666666666666,3.605551275463989
434,1585,29236,180,435,436,709,256,274,1060,70144,0.9343065693430656,374.98266626605556
435,892,2721,224,886,399,934,175,48,446,8400,3.6458333333333335,181.46349495146399
436,577,2721,166,853,446,1028,280,175,910,49000,1.6,330.1893396219811
437,572,2721,171,823,452,1032,281,209,980,58729,1.3444976076555024,350.202798389733
438,1651,2721,162,836,475,1029,313,193,1012,60409,1.621761658031088,367.72000217556837
439,950,2721,147,873,447,1002,300,129,858,38700,2.3255813953488373,326.5593361090753
440,1006,2721,169,891,288,987,119,96,430,11424,1.2395833333333333,152.8953890737062
441,1333,2721,77,851,285,1025,208,174,764,36192,1.1954022988505748,271.1825953117198
442,512,17580,32,462,802,1174,770,712,2964,548240,1.0814606741573034,1048.734475451246
443,451,17580,72,475,769,1120,697,645,2684,449565,1.0806201550387595,949.649408992603
444,389,17580,139,464,941,1192,802,728,3060,583856,1.1016483516483515,1083.138033678072
445,750,31881,267,634,864,1191,597,557,2308,332529,1.0718132854578095,816.4912736827014
446,957,31881,235,818,834,1238,599,420,2038,251580,1.4261904761904762,731.5743297847458
447,335,31881,249,706,712,1170,463,464,1854,214832,0.9978448275862069,655.4883675550619
448,749,13336,10,358,470,515,460,157,1234,72220,2.929936305732484,486.0545236905012
449,73,13336,26,234,425,527,399,293,1384,116907,1.3617747440273038,495.025251881154
450,334,13336,18,227,490,528,472,301,1546,142072,1.5681063122923589,559.8080028009604
451,1327,13336,26,246,478,530,452,284,1472,128368,1.5915492957746482,533.8164478545036
452,338,13336,53,249,465,537,412,288,1400,118656,1.4305555555555556,502.68081324037024
453,741,13336,13,240,14,242,1,2,6,2,0.5,2.23606797749979
454,630,13336,132,253,416,397,284,144,856,40896,1.9722222222222223,318.4211048281819
455,1052,13336,26,251,486,515,460,264,1448,121440,1.7424242424242424,530.3734533326493
456,1485,13336,12,238,492,535,480,297,1554,142560,1.616161616161616,564.4546040205537
457,552,13899,152,825,355,1016,203,191,788,38773,1.06282722513089,278.72925931807015
458,1514,13899,188,904,260,997,72,93,330,6696,0.7741935483870968,117.61377470347595
459,1466,13899,191,867,313,997,122,130,504,15860,0.9384615384615383,178.2806775845324
460,1739,13899,152,833,304,1036,152,203,710,30856,0.7487684729064039,253.60007886434104
461,1211,13899,194,889,282,1010,88,121,418,10648,0.7272727272727273,149.61617559608987
462,1086,13899,193,879,266,967,73,88,322,6424,0.8295454545454546,114.33722053644648
463,1462,13899,179,866,290,975,111,109,440,12099,1.018348623853211,155.56991997169632
464,1299,13899,177,886,291,984,114,98,424,11172,1.163265306122449,150.33296378372907
465,161,13899,153,845,331,1008,178,163,682,29014,1.0920245398773003,241.3565826738521
466,449,13899,193,877,277,1012,84,135,438,11340,0.6222222222222222,159.0
467,606,18546,56,791,77,799,21,8,58,168,2.625,22.47220505424423
468,163,18546,51,784,88,818,37,34,142,1258,1.088235294117647,50.24937810560445
469,774,18546,53,785,87,813,34,28,124,952,1.2142857142857142,44.04543109109048
470,824,18546,54,787,79,807,25,20,90,500,1.25,32.01562118716424
471,317,18546,53,786,89,811,36,25,122,900,1.44,43.829214001622255
472,1514,14676,378,622,538,826,160,204,728,32640,0.7843137254901961,259.26048676958084
473,310,14676,327,606,553,799,226,193,838,43618,1.1709844559585492,297.1952220342716
474,1086,14676,401,612,499,758,98,146,488,14308,0.6712328767123288,175.84083712266613
475,1159,14676,337,613,563,861,226,248,948,56048,0.9112903225806452,335.5294323900662
476,383,14676,375,622,551,795,176,173,698,30448,1.0173410404624277,246.78938388836744
477,1684,14676,332,614,541,866,209,252,922,52668,0.8293650793650794,327.3912033027155
478,1681,14676,261,601,643,795,382,194,1152,74108,1.9690721649484535,428.43902716722715
479,552,14676,341,595,565,845,224,250,948,56000,0.8959999999999999,335.6724594005293
480,664,14676,361,629,554,777,193,148,682,28564,1.304054054054054,243.21389762922678
481,161,14676,249,545,708,960,459,415,1748,190485,1.106024096385542,618.7939883353748
482,1389,7707,94,1007,170,1084,76,77,306,5852,0.987012987012987,108.18964830333815
483,1442,7707,98,1014,161,1070,63,56,238,3528,1.125,84.29116205154607
484,1508,7707,95,1005,116,1083,21,78,198,1638,0.2692307692307692,80.77747210701756
485,985,22165,86,459,333,648,247,189,872,46683,1.3068783068783072,311.01446911679204
486,55,22165,114,461,309,636,195,175,740,34125,1.1142857142857143,262.01145013147806
487,1083,22165,29,415,295,626,266,211,954,56126,1.2606635071090049,339.52466773417217
488,1406,22165,77,475,338,626,261,151,824,39411,1.7284768211920531,301.53275112332324
489,1677,22165,151,496,192,564,41,68,218,2788,0.6029411764705882,79.40403012442127
490,1518,22165,11,213,570,639,559,426,1970,238134,1.3122065727699528,702.8207452828922
491,442,22165,60,419,312,647,252,228,960,57456,1.1052631578947372,339.8352542041511
492,1682,22165,39,448,275,645,236,197,866,46492,1.1979695431472082,307.4166553718259
493,1163,22165,109,468,220,630,111,162,546,17982,0.6851851851851852,196.3797341886377
494,994,7591,93,260,523,651,430,391,1642,168130,1.0997442455242967,581.1892979055963
495,502,7591,117,247,749,712,632,465,2194,293880,1.3591397849462366,784.6330352464138
496,1698,7591,91,244,748,712,657,468,2250,307476,1.4038461538461535,806.6430437312405
497,662,28353,54,498,281,650,227,152,758,34504,1.493421052631579,273.19040978775223
498,1580,28353,50,519,291,637,241,118,718,28438,2.0423728813559316,268.337474088134
499,822,28353,67,535,226,622,159,87,492,13833,1.827586206896552,181.24568960391858
500,1081,28353,61,515,249,629,188,114,604,21432,1.649122807017544,219.8635940759634
501,831,28353,47,497,258,639,211,142,706,29962,1.4859154929577465,254.33245958783948
502,1034,28353,85,521,222,625,137,104,482,14248,1.3173076923076923,172.00290695217916
503,611,24976,215,493,451,829,236,336,1144,79296,0.7023809523809523,410.5995616169116
504,119,24976,172,515,485,982,313,467,1560,146171,0.6702355460385439,562.1903592200777
505,998,24976,51,497,483,1001,432,504,1872,217728,0.8571428571428571,663.8072009250878
506,501,24976,237,507,454,999,217,492,1418,106764,0.4410569105691057,537.7294858941622
507,387,24976,104,476,454,1054,350,578,1856,202300,0.6055363321799307,675.7099969661541
508,1158,21040,117,698,613,1122,496,424,1840,210304,1.169811320754717,652.5273940609696
509,1461,21040,150,690,489,1024,339,334,1346,113226,1.0149700598802396,475.8959970413704
510,1689,21040,172,721,541,1106,369,385,1508,142065,0.9584415584415584,533.2785388518837
511,1370,30093,52,971,542,1399,490,428,1836,209720,1.144859813084112,650.6027974117542
512,1044,30093,51,975,530,1397,479,422,1802,202138,1.1350710900473933,638.3768479511142
513,62,30093,60,984,527,1333,467,349,1632,162983,1.33810888252149,583.0008576323023
514,230,30742,262,595,424,813,162,218,760,35316,0.7431192660550459,271.6026509443529
515,922,30742,240,574,523,824,283,250,1066,70750,1.1320000000000001,377.6095867427097
516,936,30742,267,637,468,800,201,163,728,32763,1.2331288343558282,258.7856255668
517,391,30742,286,544,451,814,165,270,870,44550,0.6111111111111112,316.4253466459348
518,886,30742,249,627,414,810,165,183,696,30195,0.9016393442622952,246.40211038057285
519,118,30742,237,582,439,842,202,260,924,52520,0.7769230769230769,329.24762717444145
520,568,30742,249,580,463,834,214,254,936,54356,0.84251968503937,332.13250367887815
521,998,30742,251,587,464,804,213,217,860,46221,0.9815668202764976,304.06907110063
522,1706,30742,199,549,524,891,325,342,1334,111150,0.9502923976608189,471.79338698205595
523,1580,27663,185,752,743,1159,558,407,1930,227106,1.371007371007371,690.6612773277506
524,831,27663,167,761,687,1077,520,316,1672,164320,1.6455696202531649,608.486647347335
525,1257,27663,202,754,709,1156,507,402,1818,203814,1.2611940298507462,647.0340021977207
526,656,27663,256,791,732,1185,476,394,1740,187544,1.2081218274111676,617.9093784690438
527,1298,27663,210,763,738,1189,528,426,1908,224928,1.2394366197183098,678.4246457787335
528,563,12701,79,868,453,1160,374,292,1332,109208,1.2808219178082192,474.48919903407705
529,1314,12701,55,866,441,1164,386,298,1368,115028,1.2953020134228188,487.64741360946437
530,1045,12701,83,882,354,1096,271,214,970,57994,1.266355140186916,345.3071096864355
531,1638,12701,45,862,460,1172,415,310,1450,128650,1.3387096774193548,518.000965250066
532,3,12701,48,870,462,1176,414,306,1440,126684,1.3529411764705883,514.8125872587033
533,504,12701,45,861,465,1162,420,301,1442,126420,1.3953488372093024,516.7213949508962
534,391,12701,47,870,445,1170,398,300,1396,119400,1.3266666666666669,498.4014446206993
535,1380,33682,344,521,654,981,310,460,1540,142600,0.6739130434782609,554.7071299343465
536,1191,33682,331,672,557,879,226,207,866,46782,1.0917874396135263,306.4718584144391
537,1055,33682,409,523,616,944,207,421,1256,87147,0.4916864608076009,469.13750649463105
538,415,33682,415,549,615,663,200,114,628,22800,1.7543859649122806,230.20860105565126
539,182,33682,273,522,650,990,377,468,1690,176436,0.8055555555555556,600.9600652289635
540,410,33682,306,532,636,959,330,427,1514,140910,0.7728337236533958,539.656372148055
541,128,33682,38,524,655,990,617,466,2166,287522,1.3240343347639485,773.2043714309949
542,951,33682,334,542,647,950,313,408,1442,127704,0.7671568627450981,514.2304930670681
543,1132,33682,426,538,629,842,203,304,1014,61712,0.6677631578947368,365.54753452868476
544,952,33682,436,553,623,908,187,355,1084,66385,0.5267605633802817,401.24057621332366
545,1640,1983,64,722,271,935,207,213,840,44091,0.9718309859154929,297.0151511286924
546,1602,1983,120,720,243,879,123,159,564,19557,0.7735849056603774,201.02238681301145
547,1480,1983,97,744,239,903,142,159,602,22578,0.8930817610062893,213.17832910500073
548,1684,15471,181,368,442,638,261,270,1062,70470,0.9666666666666668,375.5276288104512
549,1681,15471,172,352,539,642,367,290,1314,106430,1.2655172413793103,467.748864242341
550,56,15471,219,372,466,646,247,274,1042,67678,0.9014598540145984,368.89700459613385
551,370,16944,60,779,588,1292,528,513,2082,270864,1.0292397660818713,736.1745716879931
552,1592,16944,116,785,570,1208,454,423,1754,192042,1.0732860520094565,620.519943273381
553,768,16944,40,760,594,1303,554,543,2194,300822,1.0202578268876612,775.7351352104661
554,1107,15635,70,896,474,1164,404,268,1344,108272,1.507462686567164,484.809240836022
555,1174,15635,67,932,502,1172,435,240,1350,104400,1.8125,496.8148548503758
556,1117,15635,55,910,514,1179,459,269,1456,123471,1.7063197026022303,532.0169170242616
557,1598,15635,46,859,575,1219,529,360,1778,190440,1.4694444444444446,639.8757691927394
558,219,15635,330,947,495,1081,165,134,598,22110,1.2313432835820894,212.55822731665788
559,732,15635,327,990,433,1062,106,72,356,7632,1.4722222222222223,128.14054783713078
560,1554,25112,220,662,635,1143,415,481,1792,199615,0.8627858627858628,635.2841883755647
561,291,25112,317,681,609,1088,292,407,1398,118844,0.7174447174447175,500.9121679496317
562,189,25112,263,551,606,1172,343,621,1928,213003,0.5523349436392915,709.429348138347
563,1123,25112,106,665,619,1181,513,516,2058,264708,0.994186046511628,727.6159701380942
564,952,25112,285,794,568,1146,283,352,1270,99616,0.8039772727272727,451.6558424287236
565,957,25112,266,752,642,1184,376,432,1616,162432,0.8703703703703703,572.7128425310541
566,12,25112,303,790,593,1146,290,356,1292,103240,0.8146067415730337,459.16881427204964
567,947,7090,102,791,396,1027,294,236,1060,69384,1.2457627118644068,377.00397875884545
568,1420,7090,102,794,386,1026,284,232,1032,65888,1.2241379310344829,366.7151483099655
569,1133,7090,97,799,381,1014,284,215,998,61060,1.3209302325581396,356.2035934686791
570,1433,7090,102,791,381,1029,279,238,1034,66402,1.1722689075630253,366.7219655270188
571,1646,7090,101,806,363,1013,262,207,938,54234,1.2657004830917875,333.90567530367014
572,952,7090,245,919,246,920,1,1,4,1,1.0,1.4142135623730951
573,1158,21659,78,852,664,1305,586,453,2078,265458,1.293598233995585,740.6787427758408
574,1088,21659,159,884,671,1366,512,482,1988,246784,1.062240663900415,703.1841863978456
575,55,21659,101,852,681,1332,580,480,2120,278400,1.2083333333333333,752.8612089887484
576,858,26654,28,567,140,642,112,75,374,8400,1.4933333333333334,134.79243302203577
577,860,26654,29,563,30,564,1,1,4,1,1.0,1.4142135623730951
578,1454,26654,36,575,127,641,91,66,314,6006,1.3787878787878791,112.4144118874444
579,1585,28917,91,235,579,834,488,599,2174,292312,0.8146911519198664,772.6221586260648
580,1026,28917,85,284,605,888,520,604,2248,314080,0.8609271523178808,797.0043914559066
581,831,28917,65,210,582,857,517,647,2328,334499,0.7990726429675425,828.1895918206169
582,853,22538,127,338,581,772,454,434,1776,197036,1.0460829493087558,628.0700597863267
583,1182,22538,179,343,564,724,385,381,1532,146685,1.010498687664042,541.6511792657707
584,125,22538,95,327,584,675,489,348,1674,170172,1.4051724137931034,600.1874707122766
585,296,19962,217,815,895,1235,678,420,2196,284760,1.6142857142857143,797.5487445918275
586,1290,19962,242,749,791,1249,549,500,2098,274500,1.0979999999999999,742.5638019725982
587,1148,19962,237,829,864,1242,627,413,2080,258951,1.5181598062953996,750.7982418732745
588,252,794,508,1017,1027,1554,519,537,2112,278703,0.9664804469273744,746.8132296632137
589,1383,794,604,1005,1033,1639,429,634,2126,271986,0.6766561514195584,765.5044088703866
590,1019,794,840,1190,977,1374,137,184,642,25208,0.7445652173913043,229.40139493908924
591,862,794,48,945,284,1103,236,158,788,37288,1.4936708860759491,284.0070421662111
592,436,794,645,991,1049,1555,404,564,1936,227856,0.7163120567375887,693.7665313345693
593,1508,794,41,895,307,1293,266,398,1328,105868,0.6683417085427136,478.70659072128933
594,422,794,57,950,974,1345,917,395,2624,362215,2.321518987341772,998.4558077351245
595,1725,794,209,930,1031,1631,822,701,3046,576222,1.1726105563480742,1080.317083082555
596,1385,794,122,991,1051,1520,929,529,2916,491441,1.7561436672967865,1069.0565934505057
597,533,794,723,1060,1049,1567,326,507,1666,165282,0.6429980276134122,602.7644647787392
598,119,25975,113,768,510,1086,397,318,1430,126246,1.2484276729559751,508.65803837155664
599,501,25975,186,803,512,1077,326,274,1200,89324,1.1897810218978102,425.8544352240563
600,1470,25975,108,783,503,1089,395,306,1402,120870,1.2908496732026145,499.66088500101745
601,1218,25975,114,767,476,1116,362,349,1422,126338,1.0372492836676217,502.83695170502335
602,507,25975,143,817,487,1072,344,255,1198,87720,1.3490196078431371,428.20672577623066
603,1046,25975,190,846,452,1003,262,157,838,41134,1.6687898089171975,305.4390282855156
604,1222,22475,36,658,155,751,119,93,424,11067,1.2795698924731185,151.02979838429235
605,110,22475,36,659,168,748,132,89,442,11748,1.4831460674157304,159.20113064925135
606,65,22475,36,658,170,751,134,93,454,12462,1.4408602150537635,163.11039206623224
607,930,22475,41,660,161,742,120,82,404,9840,1.4634146341463414,145.3409783921933
608,879,22475,32,656,171,759,139,103,484,14317,1.3495145631067962,173.0028901492689
609,323,801,68,671,241,875,173,204,754,35292,0.8480392156862745,267.47897113605023
610,1602,801,56,682,211,846,155,164,638,25420,0.945121951219512,225.656819085974
611,886,801,43,672,212,870,169,198,734,33462,0.8535353535353535,260.31711430484165
612,265,8180,94,749,595,1623,501,874,2750,437874,0.5732265446224256,1007.4110382559842
613,154,8180,71,841,592,1563,521,722,2486,376162,0.7216066481994459,890.3510543600204
614,1685,8180,83,814,624,1359,541,545,2172,294845,0.9926605504587156,767.923173240657
615,213,8180,74,815,601,1604,527,789,2632,415803,0.6679340937896071,948.8150504708491
616,448,8180,107,814,612,1567,505,753,2516,380265,0.6706507304116865,906.6609068444498
617,1389,12543,32,642,82,675,50,33,166,1650,1.5151515151515151,59.90826320300064
618,1668,12543,33,641,82,676,49,35,168,1715,1.4,60.21627686929839
619,650,12543,35,641,86,674,51,33,168,1683,1.5454545454545454,60.74537019394976
620,1672,12543,32,643,83,680,51,37,176,1887,1.3783783783783785,63.00793600809346
621,963,12543,33,647,83,671,50,24,148,1200,2.083333333333333,55.46169849544819
622,909,12543,36,641,80,678,44,37,162,1628,1.1891891891891893,57.48912940721924
623,289,23680,41,835,102,852,61,17,156,1037,3.5882352941176467,63.324560795950255
624,1122,23680,38,825,121,875,83,50,266,4150,1.66,96.89685237405806
625,26,23680,35,826,121,878,86,52,276,4472,1.6538461538461535,100.4987562112089
626,1010,23680,42,829,56,878,14,49,126,686,0.2857142857142857,50.96076922496363
627,1544,23680,37,828,119,873,82,45,254,3690,1.8222222222222224,93.53608929178085
628,576,23680,39,830,116,880,77,50,254,3850,1.54,91.80958555619343
629,120,23680,40,827,122,875,82,48,260,3936,1.7083333333333333,95.01578816175763
630,1483,23680,44,832,116,874,72,42,228,3024,1.7142857142857142,83.35466393669883
631,15,23680,39,828,121,876,82,48,260,3936,1.7083333333333333,95.01578816175763
632,447,15842,124,234,735,761,611,527,2276,321997,1.159392789373814,806.8766944211488
633,552,15842,143,270,704,744,561,474,2070,265914,1.1835443037974684,734.4365186998806
634,1584,15842,81,221,749,765,668,544,2424,363392,1.2279411764705883,861.4870863802893
635,1684,15842,95,244,730,753,635,509,2288,323215,1.2475442043222005,813.8218478266604
636,1254,4631,80,767,364,980,284,213,994,60492,1.3333333333333333,355.0
637,873,4631,71,771,364,983,293,212,1010,62116,1.3820754716981132,361.65314874890834
638,661,4631,52,739,374,1014,322,275,1194,88550,1.1709090909090907,423.4489343474606
639,100,4631,67,741,370,1007,303,266,1138,80598,1.1390977443609025,403.1935019317648
640,1396,4631,72,734,359,978,287,244,1062,70028,1.1762295081967211,376.70280062670093
641,1404,4631,63,743,376,1015,313,272,1170,85136,1.150735294117647,414.67215966351057
642,886,10544,27,540,124,608,97,68,330,6596,1.4264705882352942,118.46096403457132
643,1599,10544,50,541,126,597,76,56,264,4256,1.3571428571428572,94.40338976964757
644,782,10544,29,540,120,609,91,69,320,6279,1.318840579710145,114.20157617125956
645,1319,9467,97,714,334,872,237,158,790,37446,1.5,284.83855076165514
646,384,9467,121,718,322,845,201,127,656,25527,1.5826771653543308,237.76038357977134
647,886,9467,120,750,294,836,174,86,520,14964,2.0232558139534884,194.09276132818556
648,1377,34973,112,328,523,594,411,266,1354,109326,1.545112781954887,489.56817707036475
649,1422,34973,67,243,724,755,657,512,2338,336384,1.283203125,832.9423749575957
650,191,34973,125,404,548,685,423,281,1408,118863,1.5053380782918149,507.8287112796991
651,525,34973,104,379,519,548,415,169,1168,70135,2.455621301775148,448.09150851137537
652,1546,34973,45,740,48,743,3,3,12,9,1.0,4.242640687119285
653,1186,34973,64,304,759,785,695,481,2352,334295,1.4449064449064448,845.2135824748677
654,751,34973,48,279,547,718,499,439,1876,219061,1.1366742596810937,664.621696907346
655,1332,34973,88,342,586,678,498,336,1668,167328,1.4821428571428572,600.7495318350236
656,338,34973,310,342,520,644,210,302,1024,63420,0.6953642384105961,367.8369203872825
657,1684,14203,59,1110,79,1126,20,16,72,320,1.25,25.612496949731394
658,161,14203,58,1109,81,1127,23,18,82,414,1.2777777777777777,29.206163733020468
659,1211,14203,61,1112,73,1121,12,9,42,108,1.3333333333333333,15.0
660,1462,14203,61,1109,73,1120,12,11,46,132,1.0909090909090908,16.278820596099706
661,664,14203,57,1111,79,1126,22,15,74,330,1.4666666666666666,26.627053911388696
662,1086,14203,60,1110,71,1119,11,9,40,99,1.2222222222222223,14.212670403551895
663,552,14203,59,1108,80,1126,21,18,78,378,1.1666666666666667,27.65863337187866
664,1159,14203,60,1109,77,1127,17,18,70,306,0.9444444444444444,24.758836806279895
665,71,20379,230,290,567,670,337,380,1434,128060,0.8868421052631579,507.90648745610645
666,30,20379,236,345,527,618,291,273,1128,79443,1.065934065934066,399.0112780360976
667,476,20379,198,343,635,690,437,347,1568,151639,1.2593659942363111,558.0125446618562
668,573,9333,44,1201,491,1657,447,456,1806,203832,0.9802631578947368,638.5491367154136
669,748,9333,103,1324,392,1527,289,203,984,58667,1.4236453201970445,353.17134651610684
670,421,9333,75,1205,442,1670,367,465,1664,170655,0.789247311827957,592.379945642997
671,469,9333,63,1243,437,1614,374,371,1490,138754,1.0080862533692725,526.7988230814492
672,941,9333,70,1221,439,1670,369,449,1636,165681,0.821826280623608,581.172951882656
673,1717,9333,84,1240,456,1637,372,397,1538,147684,0.9370277078085644,544.0523871834403
674,1543,9333,58,1222,452,1648,394,426,1640,167844,0.9248826291079812,580.2689031819644
675,887,9333,67,1252,463,1641,396,389,1570,154044,1.0179948586118253,555.1008917305033
676,13,9333,46,1205,479,1660,433,455,1776,197015,0.9516483516483516,628.1034946567326
677,71,9333,75,1236,386,1578,311,342,1306,106362,0.9093567251461988,462.26074892856735
678,506,35123,91,1042,284,1196,193,154,694,29722,1.2532467532467533,246.9109151090733
679,1704,35123,61,1038,299,1208,238,170,816,40460,1.4,292.4790590794493
680,1408,35123,107,1051,240,1180,133,129,524,17157,1.0310077519379846,185.28356645962967
681,707,19861,65,1040,224,1250,159,210,738,33390,0.7571428571428571,263.40273347101015
682,496,19861,70,1051,204,1248,134,197,662,26398,0.6802030456852792,238.2540660723338
683,711,19861,77,1055,170,1176,93,121,428,11253,0.7685950413223142,152.6106156202772
684,1212,19861,51,1029,222,1211,171,182,706,31122,0.9395604395604396,249.7298540423231
685,871,19861,65,1046,219,1254,154,208,724,32032,0.7403846153846154,258.80494585691366
686,263,19861,57,1035,221,1254,164,219,766,35916,0.7488584474885844,273.60007309940545
687,266,26930,31,471,372,713,341,242,1166,82522,1.4090909090909092,418.14471179246067
688,153,26930,43,481,344,712,301,231,1064,69531,1.303030303030303,379.4232465202943
689,1585,26930,42,482,346,710,304,228,1064,69312,1.3333333333333333,380.0
690,1573,31634,156,591,406,1004,250,413,1326,103250,0.6053268765133172,482.77220301090244
691,1196,31634,115,587,510,1105,395,518,1826,204610,0.7625482625482626,651.4207549656367
692,761,31634,136,594,381,804,245,210,910,51450,1.1666666666666667,322.6840560052511
693,134,31634,97,571,485,1113,388,542,1860,210296,0.7158671586715867,666.5643254780441
694,697,31634,125,597,521,1113,396,516,1824,204336,0.7674418604651163,650.4398511776474
695,32,31634,96,621,495,1102,399,481,1760,191919,0.8295218295218295,624.9495979677081
696,1675,31634,96,563,503,1086,407,523,1860,212861,0.7782026768642447,662.7050626032669
697,255,31634,60,589,517,1114,457,525,1964,239925,0.8704761904761905,696.0416654195351
698,1508,31634,77,639,525,1097,448,458,1812,205184,0.9781659388646288,640.6777661195994
699,244,31634,53,586,516,1084,463,498,1922,230574,0.9297188755020079,679.9801467690068
700,299,11796,152,1196,735,1623,583,427,2020,248941,1.3653395784543323,722.646524934563
701,1565,11796,53,1103,799,1641,746,538,2568,401348,1.3866171003717471,919.7608384792212
702,437,11796,316,1163,760,1613,444,450,1788,199800,0.9866666666666668,632.1676992697428
703,1508,11796,38,1163,781,1602,743,439,2364,326177,1.6924829157175398,863.0005793740813
704,909,11796,233,1155,675,1491,442,336,1556,148512,1.3154761904761905,555.2116713470638
705,199,11796,151,1140,762,1583,611,443,2108,270673,1.3792325056433408,754.6986153425751
706,810,11796,61,1172,763,1618,702,446,2296,313092,1.5739910313901346,831.6970602328711
707,1663,11796,59,1165,771,1620,712,455,2334,323960,1.5648351648351648,844.9668632555954
708,963,11796,389,1230,766,1604,377,374,1502,140998,1.0080213903743316,531.0414296455598
709,1665,11796,393,1205,710,1476,317,271,1176,85907,1.169741697416974,417.0491577739967
710,115,26853,31,329,609,1128,578,799,2754,461822,0.7234042553191491,986.146540834576
711,567,26853,111,369,512,894,401,525,1852,210525,0.7638095238095238,660.6254612108135
712,273,26853,40,348,603,1104,563,756,2638,425628,0.7447089947089947,942.6054317687757
713,1643,26853,72,354,494,1064,422,710,2264,299620,0.5943661971830986,825.944308049883
714,1268,26853,52,362,574,1101,522,739,2522,385758,0.7063599458728009,904.7679260451267
715,1383,3185,79,288,583,1060,504,772,2552,389088,0.6528497409326425,921.9544457292888
716,363,3185,36,228,617,806,581,578,2318,335818,1.005190311418685,819.5395048440313
717,903,3185,20,267,563,815,543,548,2182,297564,0.9908759124087592,771.4615998220521
718,851,21839,112,397,282,546,170,149,638,25330,1.140939597315436,226.05530296810116
719,1182,21839,98,407,256,555,158,148,612,23384,1.0675675675675675,216.4901845350038
720,853,21839,97,393,250,565,153,172,650,26316,0.8895348837209303,230.20208513391012
721,1416,17132,49,893,162,1012,113,119,464,13447,0.9495798319327732,164.10362579784763
722,503,17132,35,880,152,1040,117,160,554,18720,0.73125,198.2145302443794
723,991,17132,59,912,153,1038,94,126,440,11844,0.7460317460317459,157.20050890502867
724,1198,27398,21,513,663,945,642,432,2148,277344,1.4861111111111112,773.81393112298
725,1206,27398,180,453,680,777,500,324,1648,162000,1.5432098765432098,595.7986236976383
726,818,27398,55,410,728,946,673,536,2418,360728,1.2555970149253732,860.36329535842
727,962,27398,104,457,741,910,637,453,2180,288561,1.4061810154525387,781.6508171811759
728,1671,27398,44,411,743,916,699,505,2408,352995,1.3841584158415838,862.3375209278557
729,1556,27398,198,416,696,870,498,454,1904,226092,1.0969162995594717,673.8842630600599
730,44,27398,26,409,710,941,684,532,2432,363888,1.2857142857142858,866.5333230753448
731,831,26967,51,766,547,1072,496,306,1604,151776,1.6209150326797386,582.7967055500571
732,266,26967,47,751,578,1093,531,342,1746,181602,1.5526315789473684,631.605098142819
733,1458,26967,155,775,532,1067,377,292,1338,110084,1.2910958904109588,476.8574210390355
734,1420,35652,320,250,520,494,200,244,888,48800,0.819672131147541,315.49326458737596
735,891,35652,111,230,673,512,562,282,1688,158484,1.99290780141844,628.782951422826
736,631,35652,306,243,522,524,216,281,994,60696,0.7686832740213523,354.42488625941604
737,952,35652,363,277,520,479,157,202,718,31714,0.7772277227722773,255.8378392654222
738,191,35652,309,278,561,428,252,150,804,37800,1.68,293.2643858363985
739,1435,35652,253,233,583,527,330,294,1248,97020,1.1224489795918366,441.9683246568695
740,1511,9636,24,481,976,1167,952,686,3276,653072,1.3877551020408163,1173.4138229968148
741,1588,9636,142,528,898,1077,756,549,2610,415044,1.3770491803278688,934.3109760673906
742,1210,9636,19,507,955,1065,936,558,2988,522288,1.6774193548387095,1089.7063824719023
743,952,34791,112,887,199,981,87,94,362,8178,0.9255319148936171,128.08200498118384
744,1487,34791,49,868,236,1005,187,137,648,25619,1.364963503649635,231.81458107720488
745,1186,34791,54,873,245,1004,191,131,644,25021,1.4580152671755726,231.60742647851342
746,352,34791,57,877,213,1006,156,129,570,20124,1.2093023255813953,202.42776489404807
747,20,34791,51,874,237,1000,186,126,624,23436,1.4761904761904765,224.65974272218867
748,1492,34791,94,887,222,996,128,109,474,13952,1.1743119266055049,168.12197952677099
749,69,6308,79,458,178,519,99,61,320,6039,1.6229508196721312,116.2841347734075
750,947,6308,68,446,180,543,112,97,418,10864,1.154639175257732,148.16544806398016
751,123,6308,89,452,184,533,95,81,352,7695,1.1728395061728396,124.84390253432484
752,1684,15490,66,696,848,1275,782,579,2722,452778,1.3506044905008636,973.0184993102649
753,552,15490,89,671,833,1046,744,375,2238,279000,1.984,833.1632493095216
754,1681,15490,38,696,854,1291,816,595,2822,485520,1.3714285714285714,1009.8915783389818
755,1222,33897,116,770,270,959,154,189,686,29106,0.8148148148148148,243.79704674175198
756,1271,33897,113,817,273,927,160,110,540,17600,1.4545454545454546,194.164878389476
757,925,33897,93,804,280,933,187,129,632,24123,1.4496124031007749,227.17834403833479
758,94,2014,125,563,607,929,482,366,1696,176412,1.3169398907103824,605.2107071095157
759,1199,2014,179,586,489,916,310,330,1280,102300,0.9393939393939394,452.76925690687085
760,1384,2014,99,553,655,937,556,384,1880,213504,1.4479166666666667,675.7159166395298
761,971,23861,21,373,140,434,119,61,360,7259,1.9508196721311477,133.7235955244997
762,805,23861,76,374,136,432,60,58,236,3480,1.0344827586206895,83.45058418010026
763,963,23861,22,377,134,429,112,52,328,5824,2.1538461538461537,123.48279232346505
764,592,23861,19,372,144,450,125,78,406,9750,1.6025641025641026,147.33974345029924
765,140,23861,63,373,147,431,84,58,284,4872,1.4482758620689655,102.07840124139877
766,247,23861,80,378,136,431,56,53,218,2968,1.0566037735849056,77.10382610480494
767,880,1691,99,303,319,556,220,253,946,55660,0.8695652173913043,335.2745143908198
768,1101,1691,76,308,447,548,371,240,1222,89040,1.5458333333333334,441.86083782114025
769,1169,1691,14,306,419,565,405,259,1328,104895,1.5637065637065637,480.7348541555938
770,1231,9323,51,521,124,616,73,95,336,6935,0.7684210526315789,119.80818002123227
771,1543,9323,42,516,126,611,84,95,358,7980,0.8842105263157894,126.81088281373961
772,517,9323,99,550,100,551,1,1,4,1,1.0,1.4142135623730951
773,421,9323,56,518,141,600,85,82,334,6970,1.0365853658536586,118.10588469674151
774,25,9323,84,530,110,563,26,33,118,858,0.7878787878787878,42.01190307520001
775,748,9323,65,535,131,586,66,51,234,3366,1.2941176470588236,83.40863264674707
776,887,9323,54,519,114,604,60,85,290,5100,0.7058823529411765,104.04326023342406
777,641,9323,41,522,147,603,106,81,374,8586,1.308641975308642,133.4053971921676
778,71,9323,44,520,117,605,73,85,316,6205,0.8588235294117647,112.0446339634344
779,952,25105,228,348,611,820,383,472,1710,180776,0.8114406779661016,607.842907337085
780,957,25105,74,288,753,898,679,610,2578,414190,1.1131147540983606,912.7655777909243
781,1123,25105,126,362,668,845,542,483,2050,261786,1.1221532091097308,725.9841596068057
782,886,1661,58,502,72,529,14,27,82,378,0.5185185185185185,30.4138126514911
783,1101,1661,45,499,70,530,25,31,112,775,0.8064516129032258,39.824615503479755
784,1225,1661,50,500,83,530,33,30,126,990,1.1,44.598206241955516
785,880,1661,48,500,80,526,32,26,116,832,1.2307692307692308,41.23105625617661
786,1169,1661,44,499,82,530,38,31,138,1178,1.2258064516129032,49.040799340956916
787,1585,35873,292,490,643,834,351,344,1390,120744,1.0203488372093024,491.46413907832584
788,607,35873,237,486,617,851,380,365,1490,138700,1.0410958904109588,526.9013190342191
789,1684,35873,249,492,637,812,388,320,1416,124160,1.2125,502.93538352356956
790,828,35873,56,480,658,896,602,416,2036,250432,1.4471153846153846,731.7513238799094
791,1400,35873,361,477,652,892,291,415,1412,120765,0.7012048192771084,506.8589547398763
792,1371,13983,39,694,58,709,19,15,68,285,1.2666666666666666,24.20743687382041
793,1322,13983,45,695,55,703,10,8,36,80,1.25,12.806248474865697
794,792,13983,46,695,56,709,10,14,48,140,0.7142857142857143,17.204650534085253
795,387,13983,43,694,58,709,15,15,60,225,1.0,21.213203435596427
796,1046,13983,43,695,58,708,15,13,56,195,1.1538461538461535,19.849433241279208
797,1103,13983,40,694,57,709,17,15,64,255,1.1333333333333333,22.67156809750927
798,25,8904,178,379,260,503,82,124,412,10168,0.6612903225806451,148.66068747318505
799,1181,8904,51,350,328,525,277,175,904,48475,1.582857142857143,327.6492026543022
800,71,8904,25,333,334,525,309,192,1002,59328,1.609375,363.79252328765637
801,287,8904,202,436,264,458,62,22,168,1364,2.8181818181818183,65.7875368135941
802,1717,8904,59,367,292,508,233,141,748,32853,1.6524822695035462,272.3416971379888
803,183,8904,46,319,330,548,284,229,1026,65036,1.240174672489083,364.8246153975907
804,1012,8904,133,343,276,537,143,194,674,27742,0.7371134020618557,241.0082986123092
805,29,8904,63,344,311,532,248,188,872,46624,1.319148936170213,311.20411308335883
806,525,8904,29,325,317,537,288,212,1000,61056,1.3584905660377358,357.61431738676237
807,1547,8904,38,342,326,549,288,207,990,59616,1.391304347826087,354.67308891428456
808,577,5447,57,604,853,1286,796,682,2956,542872,1.1671554252199414,1048.2079946270205
809,572,5447,66,619,703,1265,637,646,2566,411502,0.9860681114551084,907.2403209734453
810,1494,5447,334,713,338,716,4,3,14,12,1.3333333333333333,5.0
811,681,5447,434,865,586,1169,152,304,912,46208,0.5,339.882332579968
812,1553,5447,75,638,795,1254,720,616,2672,443520,1.1688311688311688,947.5526370603377
813,632,5447,39,608,902,1272,863,664,3054,573032,1.2996987951807228,1088.882454629516
814,947,5447,68,601,836,1289,768,688,2912,528384,1.1162790697674418,1031.1003830859536
815,1128,5447,56,626,718,1275,662,649,2622,429638,1.0200308166409862,927.0625653104541
816,1264,25963,108,1053,301,1185,193,132,650,25476,1.4621212121212122,233.82258231402716
817,1046,25963,208,1096,245,1156,37,60,194,2220,0.6166666666666667,70.49113419430843
818,1368,25963,157,1077,260,1121,103,44,294,4532,2.340909090909091,112.0044641967453
819,119,25963,124,1054,307,1175,183,121,608,22143,1.512396694214876,219.3855054464629
820,507,25963,157,1056,285,1175,128,119,494,15232,1.0756302521008403,174.77127910500627
821,501,25963,125,1063,287,1167,162,104,532,16848,1.5576923076923077,192.50974001333023
822,64,25963,144,1109,213,1127,69,18,174,1242,3.8333333333333335,71.30918594402827
823,1470,25963,113,1068,287,1178,174,110,568,19140,1.5818181818181818,205.854317418897
824,1218,25963,117,1033,306,1166,189,133,644,25137,1.4210526315789471,231.10603626906848
825,788,25963,197,1036,282,1180,85,144,458,12240,0.5902777777777778,167.2154299100415
826,1508,11258,31,578,34,580,3,2,10,6,1.5,3.605551275463989
827,585,11258,32,578,36,584,4,6,20,24,0.6666666666666666,7.211102550927978
828,35,11258,31,578,41,582,10,4,28,40,2.5,10.770329614269007
829,140,11258,28,575,41,585,13,10,46,130,1.3,16.401219466856727
830,1197,11258,39,579,41,580,2,1,6,2,2.0,2.23606797749979
831,594,11258,31,578,33,583,2,5,14,10,0.4,5.385164807134504
832,201,11258,30,578,41,583,11,5,32,55,2.2,12.083045973594572
833,1239,11258,28,582,31,585,3,3,12,9,1.0,4.242640687119285
834,909,11258,31,578,34,580,3,2,10,6,1.5,3.605551275463989
835,1502,18729,93,936,280,1025,187,89,552,16643,2.101123595505618,207.09901013766338
836,1728,18729,67,921,277,1046,210,125,670,26250,1.68,244.38698819699874
837,1444,18729,88,936,280,1013,192,77,538,14784,2.493506493506493,206.86469007542104
838,297,18729,72,918,281,1046,209,128,674,26752,1.6328125,245.08161905781512
839,367,18729,206,919,281,997,75,78,306,5850,0.9615384615384616,108.2081327812286
840,699,18729,78,928,282,1002,204,74,556,15096,2.756756756756757,217.00691233230336
841,761,31398,115,550,489,903,374,353,1454,132022,1.0594900849858355,514.2810515661646
842,1573,31398,154,525,462,824,308,299,1214,92092,1.0301003344481603,429.26099287030496
843,134,31398,109,537,729,987,620,450,2140,279000,1.3777777777777778,766.0939890117922
844,1196,31398,136,529,679,951,543,422,1930,229146,1.2867298578199051,687.7012432735598
845,1508,31398,57,520,669,960,612,440,2104,269280,1.3909090909090909,753.7532752830995
846,255,31398,117,508,705,992,588,484,2144,284592,1.2148760330578512,761.5773105863908
847,32,31398,129,508,687,942,558,434,1984,242172,1.2857142857142858,706.9087635614655
848,134,31392,43,742,546,1310,503,568,2142,285704,0.8855633802816901,758.7048174356084
849,1573,31392,49,656,157,829,108,173,562,18684,0.6242774566473989,203.94361965994426
850,255,31392,36,735,646,1323,610,588,2396,358680,1.0374149659863945,847.2567497518093
851,1440,31392,53,655,713,1297,660,642,2604,423720,1.02803738317757,920.7410059294633
852,761,31392,147,736,616,1221,469,485,1908,227465,0.9670103092783504,674.6747364471267
853,306,31392,63,729,586,1257,523,528,2102,276144,0.990530303030303,743.177636907893
854,1573,1751,103,516,444,677,341,161,1004,54901,2.1180124223602483,377.09680454758563
855,1017,1751,92,514,514,842,422,328,1500,138416,1.2865853658536586,534.4791857500159
856,1445,1751,96,533,341,852,245,319,1128,78155,0.768025078369906,402.2263044605611
857,1383,1751,146,671,509,862,363,191,1108,69333,1.900523560209424,410.18288603987367
858,1508,1751,40,528,447,672,407,144,1102,58608,2.826388888888889,431.723291009415
859,858,26233,65,672,422,979,357,307,1328,109599,1.1628664495114007,470.84817085765553
860,1454,26233,86,667,357,974,271,307,1156,83197,0.8827361563517915,409.49969474958095
861,31,26233,64,705,394,967,330,262,1184,86460,1.2595419847328244,421.3597038161101
862,647,26233,129,712,407,956,278,244,1044,67832,1.139344262295082,369.89187609354167
863,34,26233,80,767,351,967,271,200,942,54200,1.355,336.8100354799423
864,761,26233,168,698,361,907,193,209,804,40337,0.9234449760765552,284.48198536990003
865,1447,26233,166,703,375,790,209,87,592,18183,2.4022988505747125,226.38462845343543
866,391,13293,185,390,640,1049,455,659,2228,299845,0.6904400606980273,800.8158340092933
867,1417,13293,160,381,753,1089,593,708,2602,419844,0.8375706214689266,923.5328905891765
868,1046,13293,144,454,772,1076,628,622,2500,390616,1.0096463022508038,883.8936587621839
869,748,13386,376,584,598,813,222,229,902,50838,0.9694323144104804,318.9435686763412
870,739,13386,158,580,609,926,451,346,1594,156046,1.3034682080924855,568.4338132095944
871,685,13386,135,571,627,942,492,371,1726,182532,1.326145552560647,616.2020772441456
872,1233,13386,289,586,542,838,253,252,1010,63756,1.003968253968254,357.08962460424414
873,17,13386,350,587,528,841,178,254,864,45212,0.7007874015748031,310.16124838541646
874,1007,13386,155,592,597,911,442,319,1522,140998,1.3855799373040751,545.0917353987309
875,802,13386,216,628,549,864,333,236,1138,78588,1.4110169491525424,408.1482573771448
876,1177,13386,184,599,592,939,408,340,1496,138720,1.2,531.0969779616524
877,947,13386,187,609,615,918,428,309,1474,132252,1.3851132686084142,527.8872985780204
878,407,3433,267,860,326,932,59,72,262,4248,0.8194444444444444,93.08598175880189
879,182,3433,176,802,395,1064,219,262,962,57378,0.8358778625954199,341.4747428434496
880,577,3433,137,793,332,1018,195,225,840,43875,0.8666666666666667,297.7414986191881
881,1281,3433,116,805,360,1119,244,314,1116,76616,0.7770700636942676,397.6581446418519
882,333,3433,149,726,382,1045,233,319,1104,74327,0.7304075235109718,395.03164430207363
883,1235,3433,106,601,814,1170,708,569,2554,402852,1.2442882249560632,908.3088681720552
884,335,3433,143,728,768,1069,625,341,1932,213125,1.8328445747800584,711.9733141066455
885,464,3433,123,756,828,985,705,229,1868,161445,3.078602620087336,741.2597385532281
886,242,3433,58,532,954,1131,896,599,2990,536704,1.4958263772954925,1077.7833734104456
887,889,3433,103,688,913,1084,810,396,2412,320760,2.0454545454545454,901.61854461851
888,120,21486,66,724,157,800,91,76,334,6916,1.1973684210526316,118.56221995222593
889,342,21486,73,726,129,820,56,94,300,5264,0.5957446808510638,109.41663493271945
890,853,21486,76,727,140,795,64,68,264,4352,0.9411764705882352,93.38094023943002
891,1477,30615,23,475,79,515,56,40,192,2240,1.4,68.81860213634101
892,1046,30615,33,478,69,515,36,37,146,1332,0.972972972972973,51.62363799656123
893,1594,30615,24,475,80,516,56,41,194,2296,1.3658536585365857,69.40461079784254
894,1514,14182,227,872,944,1278,717,406,2246,291102,1.7660098522167489,823.9690528169125
895,1589,14182,42,792,912,1501,870,709,3158,616830,1.227080394922426,1122.3105630795783
896,1591,14182,137,860,926,1198,789,338,2254,266682,2.3343195266272194,858.3501616473314
897,1159,14182,204,812,947,1509,743,697,2880,517871,1.0659971305595408,1018.7531595043031
898,664,14182,40,864,885,1511,845,647,2984,546715,1.3060278207109737,1064.2527895194826
899,552,14182,75,841,944,1241,869,400,2538,347600,2.1725,956.6404758319607
900,1684,14182,354,821,993,1255,639,434,2146,277326,1.4723502304147464,772.4487037985111
901,1086,14182,605,837,859,1096,254,259,1026,65786,0.9806949806949808,362.7630080369276
902,161,14182,53,880,990,1204,937,324,2522,303588,2.8919753086419755,991.4358274744766
903,477,4408,56,847,83,881,27,34,122,918,0.7941176470588235,43.41658669218482
904,948,4408,47,848,83,882,36,34,140,1224,1.0588235294117647,49.51767361255979
905,1005,4408,53,845,87,880,34,35,138,1190,0.9714285714285714,48.79549159502341
906,1595,24307,26,348,262,636,236,288,1048,67968,0.8194444444444444,372.34392703520757
907,1700,24307,20,354,238,729,218,375,1186,81750,0.5813333333333334,433.7614551801485
908,794,24307,31,352,249,739,218,387,1210,84366,0.5633074935400517,444.17676661437395
909,1351,32513,96,807,583,1081,487,274,1522,133438,1.7773722627737227,558.7888688941468
910,874,32513,80,840,172,980,92,140,464,12880,0.6571428571428571,167.5231327309754
911,1244,32513,84,796,588,1031,504,235,1478,118440,2.1446808510638298,556.0944164438266
912,1513,32513,90,799,582,1093,492,294,1572,144648,1.673469387755102,573.149195236284
913,100,32513,76,785,576,1061,500,276,1552,138000,1.8115942028985508,571.1182014259394
914,656,32513,68,791,583,1062,515,271,1572,139565,1.900369003690037,581.9501696880928
915,134,22880,41,730,71,752,30,22,104,660,1.3636363636363635,37.20215047547655
916,1508,22880,44,732,54,750,10,18,56,180,0.5555555555555556,20.591260281974
917,438,22880,46,733,60,751,14,18,64,252,0.7777777777777778,22.80350850198276
918,1291,22880,46,732,71,753,25,21,92,525,1.1904761904761905,32.64965543462902
919,1350,22880,40,730,71,754,31,24,110,744,1.2916666666666667,39.20459156782532
920,1562,22880,42,731,68,752,26,21,94,546,1.238095238095238,33.421549934136806
921,653,22880,42,732,60,737,18,5,46,90,3.6,18.681541692269406
922,1241,22880,46,732,57,752,11,20,62,220,0.55,22.825424421026653
923,247,22880,48,732,56,738,8,6,28,48,1.3333333333333333,10.0
924,689,32067,51,595,740,1262,689,667,2712,459563,1.0329835082458771,958.9629815587252
925,237,32067,223,622,651,1162,428,540,1936,231120,0.7925925925925926,689.0457169157936
926,335,32067,251,621,585,955,334,334,1336,111556,1.0,472.34732983261375
927,947,32067,54,586,725,1253,671,667,2676,447557,1.0059970014992503,946.11310106139
928,191,32067,230,638,625,956,395,318,1426,125610,1.2421383647798745,507.09860973976254
929,128,32067,40,589,777,1253,737,664,2802,489368,1.1099397590361446,992.00050403213
930,1281,32067,40,587,731,1263,691,676,2734,467116,1.0221893491124259,966.6731608977256
931,957,32067,249,634,662,1000,413,366,1558,151158,1.128415300546448,551.837838499681
932,1654,32067,291,657,601,1063,310,406,1432,125860,0.7635467980295566,510.818950314101
933,1225,29550,19,317,561,949,542,632,2348,342544,0.8575949367088608,832.5791253688744
934,228,29550,21,307,553,972,532,665,2394,353780,0.8,851.6155235785689
935,932,29550,16,298,548,969,532,671,2406,356972,0.7928464977645305,856.3089395773
936,886,35189,195,470,714,1047,519,577,2192,299463,0.8994800693240901,776.073450132138
937,506,35189,140,486,794,1017,654,531,2370,347274,1.231638418079096,842.4232902763314
938,1046,35189,173,477,698,1021,525,544,2138,285600,0.9650735294117648,756.0165342107274
939,886,35102,213,980,834,1323,621,343,1928,213003,1.8104956268221573,709.429348138347
940,506,35102,168,959,843,1338,675,379,2108,255825,1.7810026385224274,774.1227292878049
941,169,35102,155,897,885,1362,730,465,2390,339450,1.5698924731182795,865.520074868284
942,1408,35102,247,983,794,1338,547,355,1804,194185,1.5408450704225352,652.0996856309624
943,615,35102,154,960,839,1319,685,359,2088,245915,1.9080779944289692,773.3731311598561
944,1704,35102,123,853,888,1422,765,569,2668,435285,1.344463971880492,953.4075728669245
945,814,34543,117,908,385,1167,268,259,1054,69412,1.034749034749035,372.6996109469394
946,94,34543,79,900,416,1206,337,306,1286,103122,1.1013071895424835,455.1977592211983
947,200,34543,107,909,398,1213,291,304,1190,88464,0.9572368421052632,420.82894387149753
948,242,25399,199,307,803,639,604,332,1872,200528,1.8192771084337351,689.2314560436139
949,12,25399,285,255,675,552,390,297,1374,115830,1.3131313131313131,490.2132189160141
950,957,25399,212,192,834,601,622,409,2062,254398,1.5207823960880196,744.4225950359111
951,189,25399,127,176,853,683,726,507,2466,368082,1.4319526627218937,885.5083285887265
952,941,25399,277,250,826,601,549,351,1800,192699,1.5641025641025639,651.6149169563263
953,1554,25399,128,151,855,693,727,542,2538,394034,1.3413284132841328,906.8037273853697
954,947,31749,56,1014,64,1018,8,4,24,32,2.0,8.94427190999916
955,957,31749,56,1014,64,1018,8,4,24,32,2.0,8.94427190999916
956,1230,31749,57,1015,64,1018,7,3,20,21,2.333333333333333,7.615773105863909
957,577,31749,56,1014,64,1018,8,4,24,32,2.0,8.94427190999916
958,129,31749,56,1014,64,1018,8,4,24,32,2.0,8.94427190999916
959,525,31749,57,1015,60,1017,3,2,10,6,1.5,3.605551275463989
960,470,27245,109,485,276,758,167,273,880,45591,0.6117216117216118,320.0281237641467
961,853,27245,66,475,311,651,245,176,842,43120,1.3920454545454546,301.66372005927394
962,952,27245,55,487,259,682,204,195,798,39780,1.0461538461538462,282.207370562854
963,338,27245,94,476,309,743,215,267,964,57405,0.8052434456928839,342.8031505106101
964,941,27245,40,426,324,936,284,510,1588,144840,0.5568627450980392,583.7430941775672
965,468,27245,29,406,307,846,278,440,1436,122320,0.6318181818181818,520.4651765488254
966,421,27245,66,448,348,670,282,222,1008,62604,1.2702702702702702,358.8983142897163
967,1011,27245,16,344,328,851,312,507,1638,158184,0.6153846153846154,595.3091633764761
968,944,19261,71,618,129,668,58,50,216,2900,1.16,76.57675887630658
969,891,19261,65,606,135,662,70,56,252,3920,1.25,89.64373932405988
970,1610,19261,70,610,125,661,55,51,212,2805,1.0784313725490196,75.0066663703967
971,917,13502,57,490,846,1031,789,541,2660,426849,1.4584103512014788,956.6619047500533
972,1212,13502,342,503,877,1064,535,561,2192,300135,0.9536541889483066,775.207069111215
973,597,13502,89,503,848,987,759,484,2486,367356,1.568181818181818,900.1872027528497
974,1303,22610,43,490,69,500,26,10,72,260,2.6,27.85677655436824
975,1163,22610,40,489,74,504,34,15,98,510,2.2666666666666666,37.16180835212409
976,1461,22610,37,491,71,505,34,14,96,476,2.4285714285714284,36.76955262170047
977,775,22610,34,481,74,508,40,27,134,1080,1.4814814814814814,48.25971404805462
978,772,22610,44,487,70,505,26,18,88,468,1.4444444444444444,31.622776601683793
979,55,22610,44,492,70,501,26,9,70,234,2.888888888888889,27.51363298439521
980,1079,22610,43,484,70,506,27,22,98,594,1.2272727272727273,34.828149534535996
981,165,22610,44,490,69,503,25,13,76,325,1.9230769230769231,28.178005607210743
982,983,16066,74,725,389,1107,315,382,1394,120330,0.8246073298429321,495.12523668259934
983,1681,16066,72,743,414,1095,342,352,1388,120384,0.9715909090909092,490.7830477919954
984,106,16066,123,748,311,1033,188,285,946,53580,0.6596491228070176,341.4220262373241
985,657,16066,127,752,320,1019,193,267,920,51531,0.7228464419475655,329.4510585807853
986,1509,16066,113,766,341,1016,228,250,956,57000,0.912,338.3548433228051
987,1629,16066,93,733,376,1031,283,298,1162,84334,0.9496644295302014,410.96593532797823
988,1626,16066,104,743,300,856,196,113,618,22148,1.7345132743362832,226.24102192131292
989,552,16066,106,753,362,1031,256,278,1068,71168,0.9208633093525179,377.91533443352097
990,413,17222,232,700,374,835,142,135,554,19170,1.0518518518518518,195.93111034238538
991,1374,17222,67,683,352,827,285,144,858,41040,1.9791666666666667,319.3133257476111
992,1713,17222,57,665,388,870,331,205,1072,67855,1.6146341463414635,389.3404679711576
993,1721,17222,39,652,383,826,344,174,1036,59856,1.9770114942528736,385.50226977282506
994,738,17222,44,683,223,858,179,175,708,31325,1.022857142857143,250.33177984426987
995,1375,17222,75,677,364,837,289,160,898,46240,1.80625,330.3346787729075
996,552,15026,67,749,901,1462,834,713,3094,594642,1.1697054698457223,1097.2351616677256
997,867,15026,35,770,958,1545,923,775,3396,715325,1.1909677419354838,1205.2194820861469
998,1681,15026,117,796,892,1233,775,437,2424,338675,1.7734553775743709,889.7156849241222
999,905,9021,34,357,338,510,304,153,914,46512,1.9869281045751637,340.3307215048327
1000,809,9021,14,317,261,555,247,238,970,58786,1.0378151260504205,343.0058308542291
1001,1671,9021,43,324,248,550,205,226,862,46330,0.9070796460176992,305.1245647272602
1002,519,33665,38,609,59,618,21,9,60,189,2.333333333333333,22.847319317591726
1003,1055,33665,41,609,58,621,17,12,58,204,1.4166666666666667,20.808652046684813
1004,128,33665,35,610,62,622,27,12,78,324,2.25,29.546573405388315
1005,1380,33665,38,607,61,623,23,16,78,368,1.4375,28.0178514522438
1006,410,33665,41,610,60,621,19,11,60,209,1.7272727272727273,21.95449840010015
1007,1191,33665,41,613,56,616,15,3,36,45,5.0,15.297058540778355
1008,1132,33665,42,606,62,620,20,14,68,280,1.4285714285714286,24.413111231467404
1009,952,33665,42,610,56,617,14,7,42,98,2.0,15.652475842498529
1010,191,33665,41,612,58,617,17,5,44,85,3.4,17.72004514666935
1011,1538,33665,49,608,59,619,10,11,42,110,0.9090909090909092,14.866068747318506
1012,200,35470,48,568,155,648,107,80,374,8560,1.3375,133.60014970051492
1013,94,35470,57,570,144,638,87,68,310,5916,1.2794117647058822,110.42191811411355
1014,1674,35470,68,573,140,647,72,74,292,5328,0.972972972972973,103.24727599312246
1015,303,7394,59,985,268,1194,209,209,836,43681,1.0,295.57063453597686
1016,1389,7394,49,974,265,1201,216,227,886,49032,0.9515418502202644,313.3448579440869
1017,306,7394,71,975,266,1205,195,230,850,44850,0.8478260869565217,301.53772566629203
1018,328,7815,42,198,583,480,541,282,1646,152562,1.9184397163120568,610.0860595030836
1019,1698,7815,8,197,602,479,594,282,1752,167508,2.106382978723404,657.5408732542792
1020,502,7815,22,199,580,598,558,399,1914,222642,1.3984962406015038,685.9774048757
1021,504,12466,27,465,213,596,186,131,634,24366,1.4198473282442747,227.50164834567684
1022,1314,12466,82,477,213,580,131,103,468,13493,1.2718446601941749,166.6433316997713
1023,391,12466,69,476,133,558,64,82,292,5248,0.7804878048780488,104.01922899156675
1024,1045,12466,73,481,124,544,51,63,228,3213,0.8095238095238095,81.05553651663777
1025,1599,12466,73,472,131,559,58,87,290,5046,0.6666666666666666,104.5609869884557
1026,3,12466,54,481,137,554,83,73,312,6059,1.1369863013698631,110.5350623105628
1027,839,12466,84,484,198,585,114,101,430,11514,1.1287128712871286,152.3056138164316
1028,1638,12466,30,473,124,559,94,86,360,8084,1.0930232558139534,127.40486646906389
1029,563,12466,69,482,218,575,149,93,484,13857,1.6021505376344083,175.64168070250295
1030,161,32310,29,554,163,652,134,98,464,13132,1.3673469387755102,166.01204775557707
1031,1468,32310,48,525,165,629,117,104,442,12168,1.125,156.54072952429985
1032,107,32310,41,537,214,651,173,114,574,19722,1.5175438596491229,207.18349355100662
1033,872,32310,62,536,177,614,115,78,386,8970,1.4743589743589745,138.95682782792647
1034,656,32310,61,526,201,646,140,120,520,16800,1.1666666666666667,184.39088914585776
1035,14,11383,182,307,853,808,671,501,2344,336171,1.3393213572854292,837.4019345571157
1036,419,11383,253,420,724,786,471,366,1674,172386,1.286885245901639,596.4872169627779
1037,952,11383,229,408,403,557,174,149,646,25926,1.1677852348993292,229.0785891348207
1038,848,11383,191,352,849,807,658,455,2226,299390,1.446153846153846,799.9931249704588
1039,1281,11383,188,305,851,802,663,497,2320,329511,1.3340040241448692,828.6000241370983
1040,888,11383,125,288,841,805,716,517,2466,370172,1.3849129593810443,883.1449484654261
1041,1061,11383,257,352,833,786,576,434,2020,249984,1.3271889400921661,721.201774817561
1042,126,11383,203,380,621,741,418,361,1558,150898,1.1578947368421053,552.3087904424481
1043,753,11383,219,301,512,746,293,445,1476,130385,0.6584269662921348,532.7982732704752
1044,570,11383,216,320,704,692,488,372,1720,181536,1.3118279569892473,613.6187741586791
1045,637,11383,198,294,833,805,635,511,2292,324485,1.2426614481409002,815.0742297484322
1046,688,11383,416,563,624,698,208,135,686,28080,1.5407407407407407,247.9697562203907
1047,916,6646,38,535,346,808,308,273,1162,84084,1.1282051282051282,411.5738086904948
1048,1621,6646,22,515,326,787,304,272,1152,82688,1.1176470588235294,407.9215610874228
1049,52,6646,21,521,346,819,325,298,1246,96850,1.0906040268456376,440.9410391424232
1050,182,3414,92,1028,127,1078,35,50,170,1750,0.7,61.032778078668514
1051,577,3414,89,1022,130,1078,41,56,194,2296,0.7321428571428571,69.40461079784254
1052,348,3414,92,1030,127,1069,35,39,148,1365,0.8974358974358975,52.40229002629561
1053,421,3414,99,1031,126,1061,27,30,114,810,0.9,40.36087214122113
1054,242,3414,75,1019,148,1084,73,65,276,4745,1.1230769230769229,97.74456506629922
1055,1711,3414,99,1031,128,1071,29,40,138,1160,0.725,49.4064773081425
1056,889,3414,71,1017,152,1083,81,66,294,5346,1.2272727272727273,104.48444860360799
1057,335,3414,87,1025,132,1070,45,45,180,2025,1.0,63.63961030678928
1058,407,3414,102,1035,126,1066,24,31,110,744,0.7741935483870968,39.20459156782532
1059,252,28469,345,342,567,890,222,548,1540,121656,0.4051094890510949,591.2596722253261
1060,1442,28469,177,376,710,864,533,488,2042,260104,1.0922131147540983,722.656903378083
1061,1570,28469,317,376,549,826,232,450,1364,104400,0.5155555555555555,506.2845049969434
1062,1662,28469,292,309,567,877,275,568,1686,156200,0.4841549295774648,631.0697267339007
1063,1206,28469,191,294,663,633,472,339,1622,160008,1.392330383480826,581.1239110551209
1064,1198,28469,297,330,580,602,283,272,1110,76976,1.0404411764705883,392.5213369996592
1065,862,28469,261,303,609,894,348,591,1878,205668,0.5888324873096447,685.8461926700476
1066,75,7243,391,585,727,1062,336,477,1626,160272,0.7044025157232704,583.4595101633017
1067,418,7243,394,579,796,1009,402,430,1664,172860,0.9348837209302324,588.6459037485948
1068,1433,7243,429,661,743,1022,314,361,1350,113354,0.8698060941828255,478.4527144870222
1069,1646,7243,418,628,732,931,314,303,1234,95142,1.0363036303630364,436.3542139134215
1070,742,7243,416,599,862,1015,446,416,1724,185536,1.0721153846153846,609.8950729428792
1071,1427,7243,363,565,839,1004,476,439,1830,208964,1.0842824601366745,647.5314664168839
1072,341,7243,477,664,804,1060,327,396,1446,129492,0.8257575757575758,513.5610966574474
1073,1420,7243,408,633,827,1048,419,415,1668,173885,1.0096385542168675,589.733838269435
1074,952,7243,592,827,596,831,4,4,16,16,1.0,5.656854249492381
1075,25,7243,501,613,614,811,113,198,622,22374,0.5707070707070707,227.9758759167294
1076,1133,7243,475,674,766,1037,291,363,1308,105633,0.8016528925619835,465.2418725781247
1077,571,34910,42,326,130,403,88,77,330,6776,1.1428571428571428,116.93160394008115
1078,952,34910,65,332,117,396,52,64,232,3328,0.8125,82.46211251235322
1079,191,34910,61,336,117,399,56,63,238,3528,0.8888888888888888,84.29116205154607
1080,345,34910,54,328,121,398,67,70,274,4690,0.9571428571428572,96.89685237405806
1081,1186,34910,40,324,141,407,101,83,368,8383,1.216867469879518,130.728726758888
1082,20,34910,35,322,143,403,108,81,378,8748,1.3333333333333333,135.0
1083,1422,34910,39,324,139,405,100,81,362,8100,1.2345679012345678,128.68954891520912
1084,707,19834,123,468,545,763,422,295,1434,124490,1.4305084745762713,514.8873663239369
1085,1158,19834,303,532,472,672,169,140,618,23660,1.2071428571428569,219.45614596087302
1086,309,19834,275,479,487,652,212,173,770,36676,1.2254335260115607,273.6293112954093
1087,377,19834,156,381,464,765,308,384,1384,118272,0.8020833333333334,492.26009385283305
1088,263,19834,312,532,457,627,145,95,480,13775,1.5263157894736843,173.34935823359717
1089,1516,19834,75,376,507,750,432,374,1612,161568,1.1550802139037433,571.4017850864661
1090,1212,19834,373,535,501,656,128,121,498,15488,1.0578512396694215,176.13914953808538
1091,1212,11891,105,745,292,1083,187,338,1050,63206,0.5532544378698225,386.2809858121417
1092,1405,11891,139,768,287,1063,148,295,886,43660,0.5016949152542373,330.04393646907073
1093,917,11891,148,734,295,1026,147,292,878,42924,0.5034246575342466,326.91436187478826
1094,1165,29282,101,446,833,1163,732,717,2898,524844,1.0209205020920502,1024.6526240633946
1095,314,29282,727,935,731,939,4,4,16,16,1.0,5.656854249492381
1096,1585,29282,108,455,753,1100,645,645,2580,416025,1.0,912.1677477306463
1097,142,12515,267,464,376,557,109,93,404,10137,1.1720430107526882,143.28293687665675
1098,650,12515,142,427,402,802,260,375,1270,97500,0.6933333333333334,456.31677593531447
1099,1668,12515,78,411,399,811,321,400,1442,128400,0.8025,512.8752284912969
1100,433,12515,125,432,370,790,245,358,1206,87710,0.6843575418994413,433.80756102216566
1101,1389,12515,103,417,385,808,282,391,1346,110262,0.7212276214833759,482.0840175737005
1102,963,12515,142,427,414,763,272,336,1216,91392,0.8095238095238095,432.2961947554015
1103,909,12515,140,439,425,796,285,357,1284,101745,0.7983193277310925,456.8084937914355
1104,2,21296,181,874,398,1042,217,168,770,36456,1.2916666666666667,274.4321409747772
1105,58,21296,136,764,493,1025,357,261,1236,93177,1.367816091954023,442.2329702769797
1106,179,21296,154,830,479,1095,325,265,1180,86125,1.2264150943396226,419.3447269252351
1107,678,21296,156,805,395,1013,239,208,894,49712,1.1490384615384617,316.8359196808342
1108,729,21296,188,826,540,1126,352,300,1304,105600,1.1733333333333331,462.4975675611711
1109,1476,21296,174,813,349,988,175,175,700,30625,1.0,247.48737341529164
1110,1097,5705,151,1516,479,1903,328,387,1430,126936,0.8475452196382429,507.2997141729926
1111,1525,5705,176,1532,501,1870,325,338,1326,109850,0.9615384615384616,468.9019087186573
1112,313,5705,128,1506,501,1903,373,397,1540,148081,0.9395465994962215,544.7366336129782
1113,550,2665,373,572,1007,1209,634,637,2542,403858,0.9952904238618524,898.7352224098041
1114,105,2665,403,640,961,1215,558,575,2266,320850,0.9704347826086956,801.2421606480777
1115,1622,2665,265,628,987,1195,722,567,2578,409374,1.27336860670194,918.0266880652217
1116,1193,31252,30,576,163,677,133,101,468,13433,1.3168316831683171,167.0029939851379
1117,1508,31252,38,573,129,676,91,103,388,9373,0.883495145631068,137.44089638822936
1118,1142,31252,38,614,107,664,69,50,238,3450,1.38,85.21150157109074
1119,963,24763,46,883,66,893,20,10,60,200,2.0,22.360679774997898
1120,134,24763,45,886,65,894,20,8,56,160,2.5,21.540659228538015
1121,592,24763,43,880,67,897,24,17,82,408,1.4117647058823528,29.410882339705484
1122,258,24763,44,882,66,896,22,14,72,308,1.5714285714285714,26.076809620810597
1123,87,24763,44,885,68,894,24,9,66,216,2.6666666666666665,25.632011235952593
1124,1732,24763,53,885,65,893,12,8,40,96,1.5,14.422205101855956
1125,530,24763,44,885,66,896,22,11,66,242,2.0,24.596747752497688
1126,805,24763,56,882,67,892,11,10,42,110,1.1,14.866068747318506
1127,247,24763,56,883,66,893,10,10,40,100,1.0,14.142135623730951
1128,106,16118,66,782,145,905,79,123,404,9717,0.6422764227642277,146.18481453283715
1129,552,16118,51,791,160,895,109,104,426,11336,1.0480769230769231,150.65523555456014
1130,209,16118,183,819,185,820,2,1,6,2,2.0,2.23606797749979
1131,1582,16118,56,778,152,901,96,123,438,11808,0.7804878048780488,156.02884348735012
1132,1629,16118,58,784,167,898,109,114,446,12426,0.9561403508771931,157.7244432546839
1133,98,16118,42,795,179,901,137,106,486,14522,1.2924528301886793,173.21951391226105
1134,1681,16118,46,777,220,999,174,222,792,38628,0.7837837837837838,282.0638225650358
1135,657,16118,63,798,146,896,83,98,362,8134,0.8469387755102041,128.42507543311004
1136,891,19262,78,706,146,764,68,58,252,3944,1.1724137931034482,89.37561188601732
1137,944,19262,89,712,123,760,34,48,164,1632,0.7083333333333334,58.82176467941097
1138,894,19262,74,685,111,746,37,61,196,2257,0.6065573770491803,71.34423592694787
1139,1610,19262,73,712,126,752,53,40,186,2120,1.325,66.40030120413611
1140,1185,19262,84,701,130,762,46,61,214,2806,0.7540983606557377,76.40026177965623
1141,800,19262,77,708,125,756,48,48,192,2304,1.0,67.88225099390856
1142,1053,25065,215,648,543,1114,328,466,1588,152848,0.703862660944206,569.8596318392803
1143,1123,25065,223,577,539,1164,316,587,1806,185492,0.5383304940374787,666.6520831738246
1144,957,25065,77,521,622,1150,545,629,2348,342805,0.8664546899841018,832.2655826117045
1145,1458,28172,304,223,534,489,230,266,992,61180,0.8646616541353384,351.64755082326394
1146,153,28172,347,256,557,516,210,260,940,54600,0.8076923076923077,334.21549934136806
1147,379,28172,44,469,581,693,537,224,1522,120288,2.3973214285714284,581.8461996094844
1148,1585,28172,49,405,578,684,529,279,1616,147591,1.896057347670251,598.0652138354144
1149,917,28172,17,290,568,653,551,363,1828,200013,1.5179063360881542,659.8257345693634
1150,1216,28172,26,356,635,680,609,324,1866,197316,1.879629629629629,689.82389056918
1151,266,28172,31,232,638,690,607,458,2130,278006,1.3253275109170306,760.4031825288477
1152,1743,28172,237,295,541,695,304,400,1408,121600,0.76,502.41019097944263
1153,157,28172,40,329,651,690,611,361,1944,220571,1.6925207756232687,709.6773914956007
1154,755,15980,93,643,496,1159,403,516,1838,207948,0.7810077519379846,654.7251331665831
1155,857,15980,65,599,518,1114,453,515,1936,233295,0.8796116504854369,685.8819140347703
1156,1452,15980,83,612,496,1191,413,579,1984,239127,0.7132987910189983,711.2032058420434
1157,203,15980,134,622,515,1013,381,391,1544,148971,0.9744245524296676,545.9322302264266
1158,651,15980,71,612,450,1213,379,601,1960,227779,0.6306156405990017,710.5223430688159
1159,909,15980,83,589,513,1207,430,618,2096,265740,0.6957928802588996,752.8771480128747
1160,1562,23024,63,554,307,801,244,247,982,60268,0.9878542510121456,347.1959101141602
1161,1500,23024,97,561,330,834,233,273,1012,63609,0.8534798534798534,358.91224554199874
1162,1291,23024,84,551,362,821,278,270,1096,75060,1.0296296296296297,387.5358047974406
1163,761,23024,50,539,300,839,250,300,1100,75000,0.8333333333333334,390.51248379533274
1164,488,23024,84,558,293,794,209,236,890,49324,0.8855932203389829,315.24117751334455
1165,805,23024,51,531,325,794,274,263,1074,72062,1.0418250950570342,379.7959978725421
1166,1219,10006,113,712,502,963,389,251,1280,97639,1.549800796812749,462.9492412781341
1167,458,10006,125,683,676,987,551,304,1710,167504,1.8125,629.2988161438094
1168,1411,10006,39,656,649,912,610,256,1732,156160,2.3828125,661.5406261145267
1169,783,10006,124,726,353,956,229,230,918,52670,0.9956521739130436,324.56278283253613
1170,566,10006,52,663,574,1022,522,359,1762,187398,1.4540389972144847,633.5337402222552
1171,514,10006,91,719,655,941,564,222,1572,125208,2.5405405405405403,606.1188002363893
1172,886,10006,96,745,562,951,466,206,1344,95996,2.2621359223300965,509.5017173670762
1173,1350,22892,35,657,490,955,455,298,1506,135590,1.5268456375838926,543.9016455205849
1174,438,22892,242,704,477,899,235,195,860,45825,1.205128205128205,305.3686296920494
1175,1241,22892,185,667,447,919,262,252,1028,66024,1.0396825396825398,363.52166372858716
1176,488,22892,221,667,488,943,267,276,1086,73692,0.9673913043478259,384.0117185711915
1177,1562,22892,222,674,460,911,238,237,950,56406,1.0042194092827004,335.8764653857129
1178,109,19043,62,633,385,831,323,198,1042,63954,1.6313131313131313,378.85749299703707
1179,1224,19043,110,642,343,823,233,181,828,42173,1.2872928176795577,295.0423698386386
1180,66,19043,75,632,350,807,275,175,900,48125,1.5714285714285714,325.96012026013244
1181,997,19043,65,629,349,784,284,155,878,44020,1.8322580645161293,323.5444328063767
1182,1045,19043,237,682,336,725,99,43,284,4257,2.3023255813953494,107.93516572461452
1183,1473,19043,72,621,362,803,290,182,944,52780,1.5934065934065933,342.3799059524376
1184,1534,29585,50,806,832,1592,782,786,3136,614652,0.9949109414758268,1108.7470405822962
1185,1105,29585,70,772,795,1568,725,796,3042,577100,0.9108040201005024,1076.6805468661537
1186,881,29585,178,788,780,1420,602,632,2468,380464,0.9525316455696202,872.827588931514
1187,699,18713,229,222,570,569,341,347,1376,118327,0.9827089337175792,486.5079649913247
1188,367,18713,213,169,617,611,404,442,1692,178568,0.9140271493212668,598.8154974614469
1189,297,18713,170,165,681,675,511,510,2042,260610,1.0019607843137257,721.9563698728615
1190,321,17919,160,638,504,984,344,346,1380,119024,0.9942196531791908,487.90572859928585
1191,842,17919,34,630,528,999,494,369,1726,182286,1.3387533875338753,616.601167692699
1192,170,17919,34,635,546,1000,512,365,1754,186880,1.4027397260273973,628.7837466092774
1193,1701,17919,35,628,462,1036,427,408,1670,174216,1.0465686274509804,590.5869961318147
1194,1475,17919,307,802,359,837,52,35,174,1820,1.4857142857142858,62.68173577685928
1195,456,17919,147,676,490,967,343,291,1268,99813,1.1786941580756014,449.8110714511149
1196,266,26489,30,573,111,638,81,65,292,5265,1.2461538461538462,103.85566907973777
1197,1029,26489,41,575,104,643,63,68,262,4284,0.9264705882352942,92.69843580125827
1198,1356,26489,35,579,109,634,74,55,258,4070,1.3454545454545457,92.20086767487604
1199,379,26489,49,581,98,632,49,51,200,2499,0.9607843137254902,70.7248188403477
1200,663,26489,34,574,119,637,85,63,296,5355,1.3492063492063493,105.80170130957252
1201,1098,26489,28,580,105,637,77,57,268,4389,1.350877192982456,95.80187889597991
1202,831,26489,32,575,118,638,86,63,298,5418,1.3650793650793651,106.60675400742676
1203,698,27312,103,408,169,458,66,50,232,3300,1.32,82.80096617793781
1204,862,27312,100,385,262,504,162,119,562,19278,1.3613445378151259,201.00995000248122
1205,39,27312,90,389,188,494,98,105,406,10290,0.9333333333333332,143.62799170078233
1206,1570,27312,101,401,191,492,90,91,362,8190,0.989010989010989,127.98828071350908
1207,1198,27312,100,397,168,469,68,72,280,4896,0.9444444444444444,99.03534722511958
1208,1206,27312,68,390,224,528,156,138,588,21528,1.1304347826086956,208.2786594925174
1209,818,27312,98,398,250,518,152,120,544,18240,1.2666666666666666,193.65949499056327
1210,252,27312,102,402,194,520,92,118,420,10856,0.7796610169491526,149.6262009141447
1211,1522,16891,133,902,471,1141,338,239,1154,80782,1.4142259414225942,413.96255869341616
1212,264,16891,151,908,400,1128,249,220,938,54780,1.1318181818181818,332.26645933647893
1213,1521,16891,171,960,370,1120,199,160,718,31840,1.24375,255.34486483969087
1214,1509,16891,205,968,365,1081,160,113,546,18080,1.4159292035398232,195.88006534611938
1215,370,16891,177,906,427,1177,250,271,1042,67750,0.922509225092251,368.70177650778953
1216,369,16891,232,993,325,1072,93,79,344,7347,1.1772151898734178,122.0245876862528
1217,140,23820,50,1247,365,1402,315,155,940,48825,2.032258064516129,351.0697936308392
1218,805,23820,42,1241,154,1368,112,127,478,14224,0.8818897637795275,169.33103672983285
1219,592,23820,48,1194,355,1407,307,213,1040,65391,1.4413145539906105,373.6549210167049
1220,971,23820,48,1222,362,1402,314,180,988,56520,1.7444444444444445,361.93369558525495
1221,1225,28560,54,892,486,1242,432,350,1564,151200,1.2342857142857142,555.989208528367
1222,932,28560,40,874,485,1222,445,348,1586,154860,1.2787356321839078,564.9150378596768
1223,1319,28560,59,910,397,1289,338,379,1434,128102,0.8918205804749341,507.8237883360723
1224,1400,1518,363,404,728,786,365,382,1494,139430,0.9554973821989527,528.3455308791775
1225,379,1518,377,441,631,869,254,428,1364,108712,0.5934579439252337,497.69468552517213
1226,1360,1518,294,388,768,889,474,501,1950,237474,0.9461077844311376,689.6934101468565
1227,831,1518,125,416,844,966,719,550,2538,395450,1.3072727272727274,905.2408519283694
1228,1098,1518,351,449,672,921,321,472,1586,151512,0.6800847457627118,570.8108268069203
1229,382,1518,282,437,757,893,475,456,1862,216600,1.0416666666666667,658.4534911442113
1230,909,16456,261,441,699,738,438,297,1470,130086,1.4747474747474747,529.2003401359451
1231,360,16456,327,504,691,678,364,174,1076,63336,2.0919540229885056,403.45012083279886
1232,1730,16456,332,445,697,785,365,340,1410,124100,1.0735294117647058,498.8236161209692
1233,755,16456,265,499,637,710,372,211,1166,78492,1.7630331753554502,427.6739412215806
1234,651,16456,416,546,713,640,297,94,782,27918,3.1595744680851063,311.52046481732145
1235,1557,16456,310,503,673,694,363,191,1108,69333,1.900523560209424,410.18288603987367
1236,1452,16456,323,458,721,725,398,267,1330,106266,1.4906367041198505,479.26297582851106
1237,1508,16456,297,442,666,712,369,270,1278,99630,1.3666666666666667,457.23188865169936
1238,1344,16456,346,504,729,901,383,397,1560,152051,0.9647355163727959,551.6321237926595
1239,36,16456,332,513,626,691,294,178,944,52332,1.6516853932584268,343.685903115039
1240,55,21605,284,863,506,1149,222,286,1016,63492,0.7762237762237763,362.04972034238614
1241,660,21605,315,873,412,1149,97,276,746,26772,0.35144927536231885,292.5491411711885
1242,985,21605,302,868,400,1163,98,295,786,28910,0.3322033898305085,310.85205484281425
1243,1518,21605,224,854,563,1172,339,318,1314,107802,1.0660377358490567,464.8064113155067
1244,547,21605,169,853,500,1178,331,325,1312,107575,1.0184615384615383,463.88145037282965
1245,1461,21605,145,922,501,1200,356,278,1268,98968,1.2805755395683454,451.68573145495753
1246,1677,21605,331,885,441,1143,110,258,736,28380,0.4263565891472868,280.471032372329
1247,1303,21605,318,952,403,1132,85,180,530,15300,0.4722222222222222,199.06029237394384
1248,1158,21605,292,840,459,1137,167,297,928,49599,0.5622895622895623,340.73156589902266
1249,556,21605,310,844,460,1122,150,278,856,41700,0.5395683453237411,315.88605540605937
1250,1163,21605,329,870,421,1153,92,283,750,26036,0.3250883392226148,297.578561055732
1251,852,29167,43,685,515,993,472,308,1560,145376,1.5324675324675323,563.6026969417375
1252,577,29167,51,687,267,986,216,299,1030,64584,0.7224080267558528,368.8590516715023
1253,10,29167,78,701,473,973,395,272,1334,107440,1.4522058823529411,479.59253538811464
1254,999,29167,51,675,521,998,470,323,1586,151810,1.4551083591331269,570.2885234686036
1255,1011,29167,108,688,489,994,381,306,1374,116586,1.2450980392156863,488.66859935952505
1256,744,29167,53,680,514,982,461,302,1526,139222,1.5264900662251657,551.1125111989384
1257,952,29167,148,686,341,926,193,240,866,46320,0.8041666666666667,307.97564838798536
1258,1183,29167,53,688,493,975,440,287,1454,126280,1.5331010452961673,525.3275168882742
1259,760,7439,226,206,797,761,571,555,2252,316905,1.0288288288288288,796.2826131468651
1260,1340,7439,271,318,522,567,251,249,1000,62499,1.0080321285140563,353.5562190090849
1261,1389,7439,202,254,857,829,655,575,2460,376625,1.1391304347826088,871.5790268243035
1262,1391,7439,257,206,634,632,377,426,1606,160602,0.8849765258215962,568.8629008821018
1263,362,7439,833,262,836,265,3,3,12,9,1.0,4.242640687119285
1264,486,7439,165,284,655,748,490,464,1908,227360,1.0560344827586208,674.8303490507818
1265,1620,7439,131,236,142,267,11,31,84,341,0.3548387096774194,32.89376840679705
1266,1617,7439,165,186,801,588,636,402,2076,255672,1.582089552238806,752.3961722390671
1267,492,7439,150,224,693,814,543,590,2266,320370,0.9203389830508476,801.8410066839934
1268,819,5602,47,543,760,1380,713,837,3100,596781,0.8518518518518519,1099.5171667600284
1269,701,5602,56,540,786,1229,730,689,2838,502970,1.0595065312046443,1003.8032675778655
1270,137,5602,59,524,746,1348,687,824,3022,566088,0.8337378640776699,1072.8210475191097
1271,1137,5602,115,544,416,752,301,208,1018,62608,1.4471153846153846,365.8756619399547
1272,1133,7266,122,394,295,547,173,153,652,26469,1.130718954248366,230.9502110845539
1273,75,7266,129,363,353,534,224,171,790,38304,1.3099415204678362,281.81021982887705
1274,1427,7266,104,383,302,573,198,190,776,37620,1.0421052631578946,274.4157429886267
1275,742,7266,74,380,326,581,252,201,906,50652,1.2537313432835822,322.34298503302347
1276,1433,7266,134,392,264,558,130,166,592,21580,0.7831325301204819,210.8459153030952
1277,185,7266,144,414,277,525,133,111,488,14763,1.1981981981981982,173.23394586512194
1278,947,7266,101,399,289,545,188,146,668,27448,1.2876712328767124,238.03361107205006
1279,1014,7266,136,394,291,573,155,179,668,27745,0.8659217877094972,236.78260071213003
1280,1420,7266,151,358,355,534,204,176,760,35904,1.1590909090909092,269.4290259047826
1281,1126,7266,128,411,322,560,194,149,686,28906,1.3020134228187918,244.6160256401857
1282,1008,7266,28,336,395,601,367,265,1264,97255,1.3849056603773584,452.6742758319717
1283,1097,32303,22,136,689,762,667,626,2586,417542,1.0654952076677315,914.7485993430107
1284,872,32303,131,202,628,722,497,520,2034,258440,0.9557692307692308,719.3114763438715
1285,379,32303,141,277,559,626,418,349,1534,145882,1.1977077363896849,544.5410911951457
1286,656,32303,89,206,670,722,581,516,2194,299796,1.125968992248062,777.0566259932413
1287,1468,32303,110,269,667,692,557,423,1960,235611,1.3167848699763594,699.412610695575
1288,107,32303,73,247,661,739,588,492,2160,289296,1.195121951219512,766.6863765582378
1289,161,32303,78,151,762,735,684,584,2536,399456,1.1712328767123288,899.3953524451858
1290,1592,17403,182,241,719,701,537,460,1994,247020,1.167391304347826,707.0848605365554
1291,370,17403,180,206,769,699,589,493,2164,290377,1.1947261663286004,768.0950462019658
1292,369,17403,193,266,764,654,571,388,1918,221548,1.4716494845360826,690.3513598161446
1293,161,18232,90,495,229,592,139,97,472,13483,1.4329896907216495,169.49926253526885
1294,1304,18232,77,516,200,566,123,50,346,6150,2.46,132.7742444904131
1295,1397,18232,99,490,218,580,119,90,418,10710,1.3222222222222222,149.20120642943877
1296,374,18232,106,501,173,559,67,58,250,3886,1.1551724137931034,88.61715409558128
1297,1389,13017,38,650,641,1185,603,535,2276,322605,1.1271028037383175,806.1228194264197
1298,963,13017,84,678,491,1257,407,579,1972,235653,0.7029360967184801,707.7358264211301
1299,1668,13017,58,667,510,1203,452,536,1976,242272,0.8432835820895522,701.1419257183242
1300,420,5014,78,326,398,569,320,243,1126,77760,1.316872427983539,401.807167681215
1301,1428,5014,86,350,405,571,319,221,1080,70499,1.4434389140271493,388.07473507045006
1302,577,5014,203,315,399,562,196,247,886,48412,0.7935222672064778,315.3173005085512
1303,1435,5014,233,320,403,542,170,222,784,37740,0.7657657657657657,279.6140196771256
1304,11,5014,229,332,323,567,94,235,658,22090,0.4,253.10274593532168
1305,1489,5014,38,310,392,546,354,236,1180,83544,1.5,425.4550505047507
1306,1540,5014,227,341,376,551,149,210,718,31290,0.7095238095238096,257.489805623446
1307,475,5014,225,422,378,498,153,76,458,11628,2.013157894736842,170.83617883809038
1308,1049,5014,41,298,399,565,358,267,1250,95586,1.3408239700374531,446.60161217801266
1309,1006,5014,220,364,347,563,127,199,652,25273,0.6381909547738693,236.07202290826416
1310,478,5014,85,339,392,558,307,219,1052,67233,1.4018264840182648,377.107411754264
1311,1182,13145,163,738,304,851,141,113,508,15933,1.247787610619469,180.6931099959265
1312,804,13145,115,692,290,854,175,162,674,28350,1.0802469135802468,238.47222060441337
1313,1003,13145,127,700,306,853,179,153,664,27387,1.169934640522876,235.47823678633233
1314,217,22408,230,302,815,908,585,606,2382,354510,0.9653465346534652,842.2950789361173
1315,65,22408,147,362,742,965,595,603,2396,358785,0.9867330016583749,847.1328113111898
1316,1595,22408,517,377,737,732,220,355,1150,78100,0.6197183098591549,417.6421913552317
1317,110,22408,317,397,804,957,487,560,2094,272720,0.8696428571428572,742.1381273051534
1318,1222,22408,326,407,744,880,418,473,1782,197714,0.8837209302325582,631.2313363577572
1319,463,29854,103,1035,369,1263,266,228,988,60648,1.1666666666666667,350.3426893771297
1320,1534,29854,121,1054,336,1248,215,194,818,41710,1.1082474226804124,289.5876378576958
1321,1225,29854,119,1026,323,1245,204,219,846,44676,0.9315068493150684,299.2941696725815
1322,1709,32101,51,829,233,1060,182,231,826,42042,0.7878787878787878,294.0833215264001
1323,1548,32101,77,849,233,1087,156,238,788,37128,0.6554621848739496,284.5698508275253
1324,128,32101,46,831,227,1079,181,248,858,44888,0.7298387096774194,307.02605752606735
1325,465,32101,48,843,208,1063,160,220,760,35200,0.7272727272727273,272.02941017470886
1326,947,32101,49,838,210,1074,161,236,794,37996,0.6822033898305084,285.68689154387187
1327,957,32101,51,829,234,1075,183,246,858,45018,0.7439024390243902,306.6023483276017
1328,191,32101,53,858,230,1060,177,202,758,35754,0.8762376237623762,268.57587382339466
1329,79,25583,161,656,618,1005,457,349,1612,159493,1.3094555873925502,575.0217387195027
1330,1482,25583,137,602,616,991,479,389,1736,186331,1.231362467866324,617.0591543766286
1331,941,25583,189,673,335,843,146,170,632,24820,0.8588235294117647,224.0892679268688
1332,15,25583,196,688,644,1017,448,329,1554,147392,1.3617021276595744,555.8282108709489
1333,955,25583,165,667,311,826,146,159,610,23214,0.9182389937106918,215.8633827215723
1334,409,25583,201,697,319,795,118,98,432,11564,1.2040816326530612,153.3883959105121
1335,1124,25583,203,673,310,857,107,184,582,19688,0.5815217391304348,212.8497122384712
1336,161,13862,82,1029,135,1097,53,68,242,3604,0.7794117647058824,86.21484790916237
1337,1466,13862,83,1047,131,1095,48,48,192,2304,1.0,67.88225099390856
1338,1308,13862,78,1031,128,1100,50,69,238,3450,0.7246376811594203,85.21150157109074
1339,1389,14045,52,1006,83,1035,31,29,120,899,1.0689655172413792,42.44997055358225
1340,1508,14045,51,1007,83,1035,32,28,120,896,1.1428571428571428,42.5205832509386
1341,909,14045,54,1007,76,1033,22,26,96,572,0.8461538461538461,34.058772731852805
1342,1733,14045,51,1004,99,1034,48,30,156,1440,1.6,56.60388679233962
1343,1383,14045,54,1005,98,1034,44,29,146,1276,1.5172413793103448,52.69724850502159
1344,1241,14045,53,1006,75,1033,22,27,98,594,0.8148148148148148,34.828149534535996
1345,1207,14045,52,1006,94,1034,42,28,140,1176,1.5,50.47771785649585
1346,903,14045,51,1005,97,1032,46,27,146,1242,1.7037037037037035,53.33854141237835
1347,1439,14045,52,1002,100,1033,48,31,158,1488,1.5483870967741935,57.14017850864661
1348,592,24142,227,725,896,1199,669,474,2286,317106,1.4113924050632911,819.9006037319402
1349,971,24142,218,774,908,1121,690,347,2074,239430,1.9884726224783864,772.3399510578228
1350,140,24142,361,765,842,1125,481,360,1682,173160,1.3361111111111108,600.800299600458
1351,1047,9427,79,485,260,579,181,94,550,17014,1.925531914893617,203.9534260560484
1352,841,9427,86,468,273,579,187,111,596,20757,1.6846846846846846,217.46264046957583
1353,886,9427,91,493,252,562,161,69,460,11109,2.333333333333333,175.16278143486988
1354,931,9427,115,460,256,583,141,123,528,17343,1.146341463414634,187.1095935541521
1355,1319,9427,30,412,261,581,231,169,800,39039,1.366863905325444,286.22019495486336
1356,1597,9427,79,480,261,587,182,107,578,19474,1.7009345794392523,211.12318678913502
1357,889,19745,123,357,369,557,246,200,892,49200,1.23,317.04258389055565
1358,891,19745,80,335,373,570,293,235,1056,68855,1.2468085106382978,375.598189559002
1359,1718,19745,136,351,349,523,213,172,770,36636,1.2383720930232558,273.77545543748073
1360,279,1467,23,448,78,518,55,70,250,3850,0.7857142857142857,89.02246907382428
1361,1601,1467,54,465,67,484,13,19,64,247,0.6842105263157895,23.021728866442675
1362,119,1467,46,457,71,503,25,46,142,1150,0.5434782608695652,52.354560450833695
1363,1602,1467,26,446,79,517,53,71,248,3763,0.7464788732394366,88.60022573334675
1364,935,1467,23,449,77,516,54,67,242,3618,0.8059701492537313,86.05230967266364
1365,1607,1467,26,453,76,512,50,59,218,2950,0.8474576271186439,77.33692520394123
1366,1413,1467,34,457,73,518,39,61,200,2379,0.639344262295082,72.40165743959182
1367,3,12433,32,575,152,667,120,92,424,11040,1.3043478260869563,151.2084653714864
1368,504,12433,31,575,114,653,83,78,322,6474,1.064102564102564,113.89907813498755
1369,1219,12433,42,577,137,660,95,83,356,7885,1.144578313253012,126.15070352558483
1370,993,12433,37,580,151,653,114,73,374,8322,1.5616438356164384,135.36986370680884
1371,325,12433,36,576,156,666,120,90,420,10800,1.3333333333333333,150.0
1372,1314,12433,33,574,149,666,116,92,416,10672,1.2608695652173914,148.05404418657398
1373,509,33872,56,910,73,932,17,22,78,374,0.7727272727272727,27.80287754891569
1374,1271,33872,53,909,80,928,27,19,92,513,1.4210526315789471,33.015148038438355
1375,1222,33872,62,908,73,930,11,22,66,242,0.5,24.596747752497688
1376,821,10326,19,553,368,841,349,288,1274,100512,1.2118055555555556,452.48756889001936
1377,376,10326,66,560,212,721,146,161,614,23506,0.906832298136646,217.3407462948446
1378,547,10326,39,472,362,833,323,361,1368,116603,0.8947368421052632,484.4068537913146
1379,659,10326,15,420,377,823,362,403,1530,145886,0.8982630272952854,541.7130236573605
1380,1297,10326,86,508,102,520,16,12,56,192,1.3333333333333333,20.0
1381,917,10326,30,501,290,846,260,345,1210,89700,0.7536231884057971,432.001157405857
1382,1300,10326,29,525,174,731,145,206,702,29870,0.7038834951456311,251.91466809219347
1383,261,10326,25,565,197,716,172,151,646,25972,1.1390728476821192,228.87769659798658
1384,831,10326,34,504,377,839,343,335,1356,114905,1.0238805970149254,479.4517702543187
1385,1460,10326,41,382,142,447,101,65,332,6565,1.553846153846154,120.10828447696687
1386,903,678,64,586,193,712,129,126,510,16254,1.0238095238095235,180.3247071257846
1387,141,678,32,586,210,739,178,153,662,27234,1.1633986928104576,234.71898091121648
1388,366,678,63,593,213,738,150,145,590,21750,1.0344827586206895,208.62646045025065
1389,1268,26888,83,267,699,882,616,615,2462,378840,1.001626016260163,870.4487348488709
1390,119,26888,144,379,586,822,442,443,1770,195806,0.9977426636568848,625.7899008453237
1391,452,26888,146,318,473,791,327,473,1600,154671,0.6913319238900634,575.0286949361745
1392,1216,26931,126,370,295,600,169,230,798,38870,0.7347826086956522,285.41373477812874
1393,917,26931,127,334,433,584,306,250,1112,76500,1.224,395.1404813480897
1394,379,26931,130,391,291,591,161,200,722,32200,0.805,256.7508519946915
1395,157,26931,106,380,286,590,180,210,780,37800,0.8571428571428571,276.5863337187866
1396,314,26931,152,356,313,496,161,140,602,22540,1.15,213.3565091577944
1397,1585,26931,120,368,303,584,183,216,798,39528,0.8472222222222222,283.0989226401259
1398,375,26931,108,344,423,586,315,242,1114,76230,1.3016528925619837,397.22663556211836
1399,266,26931,79,325,438,597,359,272,1262,97648,1.3198529411764706,450.40537296972826
1400,831,26931,38,314,429,593,391,279,1340,109089,1.4014336917562724,480.33529955646605
1401,1470,10273,48,580,258,705,210,125,670,26250,1.68,244.38698819699874
1402,387,10273,37,585,253,718,216,133,698,28728,1.6240601503759398,253.6631624812716
1403,392,10273,91,600,270,732,179,132,622,23628,1.356060606060606,222.40728405337808
1404,1324,10273,27,540,370,772,343,232,1150,79576,1.4784482758620692,414.0929847268606
1405,1696,10273,27,565,301,746,274,181,910,49594,1.5138121546961325,328.3854442572021
1406,3,10273,27,548,294,739,267,191,916,50997,1.3979057591623036,328.28341414089135
1407,283,10273,49,578,256,704,207,126,666,26082,1.6428571428571428,242.33241632105268
1408,1599,10273,144,565,257,722,113,157,540,17741,0.7197452229299363,193.43732835210477
1409,1326,10273,174,575,275,646,101,71,344,7171,1.4225352112676055,123.45849504995596
1410,786,10273,156,579,282,624,126,45,342,5670,2.8,133.79461872586654
1411,782,10273,35,555,301,747,266,192,916,51072,1.3854166666666667,328.05487345869443
1412,1600,10273,64,568,275,696,211,128,678,27008,1.6484375,246.78938388836744
1413,1219,10273,34,573,250,733,216,160,752,34560,1.35,268.80476186258306
1414,886,10273,44,598,255,693,211,95,612,20045,2.2210526315789467,231.40008643040736
1415,780,10273,36,550,331,742,295,192,974,56640,1.5364583333333333,351.9786925369205
1416,804,13194,38,643,111,697,73,54,254,3942,1.351851851851852,90.80198235721508
1417,334,13194,37,637,106,698,69,61,260,4209,1.1311475409836065,92.09777413162601
1418,1182,13194,62,651,103,689,41,38,158,1558,1.0789473684210529,55.90169943749474
1419,571,13194,36,650,102,696,66,46,224,3036,1.4347826086956519,80.44874144447506
1420,1715,13194,43,641,117,698,74,57,262,4218,1.2982456140350878,93.40770846134703
1421,478,13194,37,640,114,699,77,59,272,4543,1.305084745762712,97.0051545022222
1422,1724,4557,58,922,115,958,57,36,186,2052,1.5833333333333333,67.4166151627327
1423,692,4557,47,917,112,958,65,41,212,2665,1.5853658536585369,76.8505042273634
1424,1389,4557,53,922,115,959,62,37,198,2294,1.6756756756756757,72.20110802473879
1425,197,4557,61,925,83,943,22,18,80,396,1.2222222222222223,28.42534080710379
1426,1508,4557,62,920,76,942,14,22,72,308,0.6363636363636364,26.076809620810597
1427,903,64,30,436,173,564,143,128,542,18304,1.1171875,191.91925385432282
1428,366,64,22,417,244,562,222,145,734,32190,1.5310344827586206,265.15844319953305
1429,1565,64,26,425,235,559,209,134,686,28006,1.5597014925373134,248.26800035445567
1430,1508,4549,86,1041,280,1188,194,147,682,28518,1.3197278911564625,243.402958075698
1431,197,4549,122,1026,264,1175,142,149,582,21158,0.953020134228188,205.8275977608445
1432,1389,4549,85,1054,132,1107,47,53,200,2491,0.8867924528301887,70.83784299369935
1433,692,4549,264,1145,281,1168,17,23,80,391,0.7391304347826086,28.600699292150182
1434,1363,2247,42,319,578,730,536,411,1894,220296,1.3041362530413625,675.438376167656
1435,565,2247,69,322,614,733,545,411,1912,223995,1.326034063260341,682.6023732745148
1436,1103,2247,19,298,612,740,593,442,2070,262106,1.341628959276018,739.6032720317021
1437,265,7994,45,637,892,1490,847,853,3400,722491,0.992966002344666,1202.0890150067924
1438,161,7994,56,649,874,1458,818,809,3254,661762,1.011124845488257,1150.4803344690426
1439,1084,7994,98,672,814,1362,716,690,2812,494040,1.03768115942029,994.362107081721
1440,1361,7994,56,660,815,1464,759,804,3126,610236,0.9440298507462688,1105.6658627270717
1441,866,7994,66,673,745,1303,679,630,2618,427770,1.0777777777777775,926.2510458833501
1442,102,7994,262,751,759,1298,497,547,2088,271859,0.9085923217550276,739.0656263147407
1443,823,2636,66,758,517,1092,451,334,1570,150634,1.3502994011976048,561.2102992640102
1444,1097,2636,45,771,539,1087,494,316,1620,156104,1.5632911392405062,586.4230554812797
1445,105,2636,54,758,485,1082,431,324,1510,139644,1.3302469135802468,539.2003338277898
1446,1371,21793,41,654,710,1359,669,705,2748,471645,0.9489361702127659,971.8981428112721
1447,58,21793,336,667,662,1212,326,545,1742,177670,0.5981651376146789,635.0598397001655
1448,1595,21793,292,641,676,1260,384,619,2006,237696,0.6203554119547657,728.4346230101917
1449,1315,21793,51,693,658,1361,607,668,2550,405476,0.9086826347305388,902.592377543706
1450,119,21793,132,696,716,1093,584,397,1962,231848,1.4710327455919396,706.1621626793665
1451,1222,21793,192,689,742,1241,550,552,2204,303600,0.9963768115942028,779.2329561819109
1452,1409,21793,83,688,701,1268,618,580,2396,358440,1.0655172413793104,847.5399695589583
1453,724,12796,37,661,739,1399,702,738,2880,518076,0.951219512195122,1018.5519132572477
1454,3,12796,46,668,775,1383,729,715,2888,521235,1.0195804195804197,1021.110180147079
1455,781,12796,408,707,764,1331,356,624,1960,222144,0.5705128205128205,718.4093540593691
1456,1638,12796,78,685,777,1346,699,661,2720,462039,1.0574886535552193,962.0405396863481
1457,972,4032,396,811,774,1401,378,590,1936,223020,0.6406779661016949,700.7025046337426
1458,1506,4032,387,847,740,1379,353,532,1770,187796,0.6635338345864662,638.4614318813627
1459,1508,4032,534,1371,539,1374,5,3,16,15,1.6666666666666667,5.830951894845301
1460,1389,4032,399,804,817,1408,418,604,2044,252472,0.6920529801324503,734.5338657951721
1461,1562,4032,373,823,757,1423,384,600,1968,230400,0.64,712.3594598234798
1462,1342,4032,297,840,778,1455,481,615,2192,295815,0.7821138211382114,780.7598862646569
1463,1022,17366,107,954,197,1062,90,108,396,9720,0.8333333333333334,140.5844941663198
1464,1507,17366,108,971,172,1040,64,69,266,4416,0.927536231884058,94.11163583744573
1465,489,17366,131,986,172,1026,41,40,162,1640,1.025,57.28001396647874
1466,531,17366,78,962,200,1052,122,90,424,10980,1.3555555555555556,151.6047492659778
1467,648,17366,64,910,210,1075,146,165,622,24090,0.8848484848484849,220.32022149589446
1468,1444,17366,66,935,211,1074,145,139,568,20155,1.0431654676258992,200.86313748420838
1469,909,17366,85,964,216,1076,131,112,486,14672,1.1696428571428572,172.35138525698017
1470,1585,29956,54,689,258,840,204,151,710,30804,1.3509933774834435,253.80504329110562
1471,1257,29956,54,694,269,851,215,157,744,33755,1.3694267515923566,266.22171211229187
1472,105,29956,50,677,267,837,217,160,754,34720,1.35625,269.60897611170145
1473,1748,29956,58,687,241,829,183,142,650,25986,1.2887323943661972,231.63117234085743
1474,831,29956,61,689,267,825,206,136,684,28016,1.5147058823529411,246.84408034222736
1475,915,29956,35,674,283,853,248,179,854,44392,1.3854748603351956,305.8512710452582
1476,719,29956,174,774,175,775,1,1,4,1,1.0,1.4142135623730951
1477,660,21655,162,896,406,1279,244,383,1254,93452,0.6370757180156658,454.1200281863816
1478,1093,21655,155,911,200,1229,45,318,726,14310,0.14150943396226415,321.1681802420657
1479,1158,21655,82,888,505,1277,423,389,1624,164547,1.0874035989717223,574.6738205277843
1480,1112,486,74,697,413,983,339,286,1250,96954,1.1853146853146854,443.52790216625607
1481,1472,486,186,731,274,808,88,77,330,6776,1.1428571428571428,116.93160394008115
1482,886,486,45,705,370,965,325,260,1170,84500,1.25,416.20307543313515
1483,1535,486,161,754,331,901,170,147,634,24990,1.1564625850340136,224.7420743875076
1484,60,486,44,705,420,955,376,250,1252,94000,1.504,451.5263004521442
1485,1311,486,71,704,349,967,278,263,1082,73114,1.057034220532319,382.69178198649627
1486,1171,486,61,714,385,970,324,256,1160,82944,1.265625,412.9309869699778
1487,1500,23835,86,913,198,1015,112,102,428,11424,1.0980392156862746,151.4859729479928
1488,971,23835,79,923,208,1007,129,84,426,10836,1.5357142857142858,153.93829932800998
1489,592,23835,79,916,212,1011,133,95,456,12635,1.4,163.44418007380992
1490,663,34614,47,456,352,611,305,155,920,47275,1.9677419354838708,342.12570789112004
1491,918,34614,70,461,331,626,261,165,852,43065,1.5818181818181818,308.7814761283455
1492,1351,34614,60,459,344,622,284,163,894,46292,1.7423312883435582,327.4522866006588
1493,387,8585,158,608,699,1103,541,495,2072,267795,1.0929292929292929,733.2843923062866
1494,178,8585,150,634,758,1070,608,436,2088,265088,1.3944954128440368,748.1711034248783
1495,1479,8585,111,629,763,1183,652,554,2412,361208,1.1768953068592058,855.5816734830171
1496,421,22537,280,635,903,1233,623,598,2442,372554,1.0418060200668895,863.5583361881235
1497,853,22537,230,751,801,1164,571,413,1968,235823,1.3825665859564165,704.7056122949497
1498,1182,22537,304,739,783,1136,479,397,1752,190163,1.2065491183879091,622.1334262037365
1499,1698,8569,273,455,744,822,471,367,1676,172857,1.2833787465940054,597.1013314337861
1500,1319,8569,19,426,737,935,718,509,2454,365462,1.4106090373280944,880.1164695652502
1501,1479,8569,49,472,764,943,715,471,2372,336765,1.5180467091295118,856.19273531139
1502,178,8569,48,410,776,914,728,504,2464,366912,1.4444444444444444,885.4377448471462
1503,387,8569,66,457,774,927,708,470,2356,332760,1.5063829787234042,849.8023299567965
1504,327,34151,150,1043,289,1280,139,237,752,32943,0.5864978902953587,274.7544358149655
1505,318,34151,142,1075,294,1185,152,110,524,16720,1.3818181818181818,187.62729012593024
1506,509,34151,83,1063,281,1373,198,310,1016,61380,0.6387096774193548,367.8369203872825
1507,1222,34151,97,1044,264,1346,167,302,938,50434,0.5529801324503312,345.0985366529392
1508,1316,34151,146,1088,294,1199,148,111,518,16428,1.3333333333333333,185.0
1509,937,34151,150,1074,246,1109,96,35,262,3360,2.7428571428571433,102.18121158021175
1510,119,34151,113,1056,264,1300,151,244,790,36844,0.6188524590163934,286.9442454554543
1511,391,34151,50,1064,266,1314,216,250,932,54000,0.8640000000000001,330.38765110094533
1512,1529,34151,69,1044,291,1311,222,267,978,59274,0.8314606741573034,347.236230828524
1513,656,33252,41,1055,383,1282,342,227,1138,77634,1.5066079295154184,410.47898850002053
1514,1361,33252,69,1061,342,1237,273,176,898,48048,1.5511363636363635,324.81533215043896
1515,1513,33252,39,1056,399,1293,360,237,1194,85320,1.5189873417721518,431.0092806425402
1516,856,19947,223,956,844,1305,621,349,1940,216729,1.779369627507163,712.3496332560297
1517,1504,19947,683,1144,828,1245,145,101,492,14645,1.4356435643564356,176.70880000724355
1518,1202,19947,318,1043,860,1293,542,250,1584,135500,2.168,596.8785471098789
1519,1148,19947,350,1030,849,1288,499,258,1514,128742,1.934108527131783,561.7517245189373
1520,433,19947,172,992,807,1309,635,317,1904,201295,2.003154574132492,709.7281169574727
1521,763,19947,103,943,899,1362,796,419,2430,333524,1.899761336515513,899.5426615786491
1522,1618,19947,197,1140,811,1309,614,169,1566,103766,3.633136094674556,636.8335732355824
1523,296,19947,380,970,855,1305,475,335,1620,159125,1.417910447761194,581.2486559124245
1524,1290,19947,385,921,900,1406,515,485,2000,249775,1.0618556701030928,707.4249076757193
1525,752,23372,30,532,60,552,30,20,100,600,1.5,36.05551275463989
1526,182,23372,37,532,57,551,20,19,78,380,1.0526315789473684,27.586228448267445
1527,636,23372,35,531,61,551,26,20,92,520,1.3,32.802438933713454
1528,952,23372,42,533,56,546,14,13,54,182,1.0769230769230769,19.1049731745428
1529,957,23372,36,531,59,554,23,23,92,529,1.0,32.526911934581186
1530,1378,23372,46,538,52,543,6,5,22,30,1.2,7.810249675906654
1531,1123,25080,43,452,809,1102,766,650,2832,497900,1.1784615384615384,1004.6173400852684
1532,952,25080,408,564,827,989,419,425,1688,178075,0.9858823529411764,596.8132036072928
1533,687,25080,186,495,748,984,562,489,2102,274818,1.1492842535787322,744.9597304552777
1534,1053,25080,177,568,821,1056,644,488,2264,314272,1.319672131147541,808.0099009294379
1535,957,25080,62,504,893,1105,831,601,2864,499431,1.382695507487521,1025.5544841694175
1536,1222,22454,168,840,387,997,219,157,752,34383,1.3949044585987258,269.462427807663
1537,110,22454,70,856,401,1055,331,199,1060,65869,1.6633165829145728,386.21496604870197
1538,1595,22454,308,842,360,951,52,109,322,5668,0.4770642201834863,120.7683733433551
1539,1602,998,133,459,745,949,612,490,2204,299880,1.2489795918367348,783.9923469014223
1540,1527,998,107,507,732,957,625,450,2150,281250,1.3888888888888888,770.1460900374682
1541,886,998,177,536,712,957,535,421,1912,225235,1.2707838479809976,680.7833722998822
1542,1565,11214,47,171,928,786,881,615,2992,541815,1.432520325203252,1074.4235663833886
1543,805,11214,45,169,922,766,877,597,2948,523569,1.4690117252931325,1060.913757098097
1544,1508,11214,13,157,438,792,425,635,2120,269875,0.6692913385826772,764.1007786934914
1545,909,11214,116,161,842,731,726,570,2592,413820,1.2736842105263158,923.0254601038912
1546,201,11214,5,186,967,793,962,607,3138,583934,1.5848434925864912,1137.4941758092655
1547,1067,11214,9,156,908,791,899,635,3068,570865,1.415748031496063,1100.6479909580537
1548,1197,11214,228,298,692,722,464,424,1776,196736,1.0943396226415094,628.5475320132917
1549,810,11214,19,178,883,799,864,621,2970,536544,1.391304347826087,1064.0192667428537
1550,306,11214,98,148,876,769,778,621,2798,483138,1.2528180354267309,995.45215856916
1551,1357,24450,24,446,55,470,31,24,110,744,1.2916666666666667,39.20459156782532
1552,1090,24450,33,446,58,471,25,25,100,625,1.0,35.35533905932738
1553,103,24450,30,454,46,462,16,8,48,128,2.0,17.88854381999832
1554,1630,24450,26,446,63,470,37,24,122,888,1.5416666666666667,44.10215414239989
1555,375,24450,25,445,62,470,37,25,124,925,1.48,44.654227123532216
1556,920,24450,39,448,48,454,9,6,30,54,1.5,10.816653826391969
1557,215,24450,28,444,69,470,41,26,134,1066,1.5769230769230769,48.54894437575342
1558,706,24450,41,448,57,458,16,10,52,160,1.6,18.867962264113206
1559,261,9292,22,491,127,571,105,80,370,8400,1.3125,132.00378782444085
1560,1300,9292,21,480,219,590,198,110,616,21780,1.8,226.50386310171402
1561,1455,9292,25,483,197,577,172,94,532,16168,1.8297872340425527,196.01020381602586
1562,443,9292,24,481,168,575,144,94,476,13536,1.5319148936170213,171.96511274092776
1563,1588,9292,22,453,127,542,105,89,388,9345,1.1797752808988764,137.64446955835166
1564,1210,9292,22,448,215,570,193,122,630,23546,1.5819672131147542,228.32652057962954
1565,1511,9292,29,488,217,579,188,91,558,17108,2.0659340659340657,208.86598574205422
1566,598,9292,20,461,209,586,189,125,628,23625,1.5119999999999998,226.59655778497608
1567,548,16044,191,697,543,1013,352,316,1336,111232,1.1139240506329111,473.03276842096255
1568,978,16044,38,681,807,1139,769,458,2454,352202,1.6790393013100438,895.0558641783205
1569,552,16044,83,701,541,1056,458,355,1626,162590,1.2901408450704226,579.4730364736569
1570,657,16044,208,718,484,960,276,242,1036,66792,1.140495867768595,367.06947571270484
1571,1681,16044,53,691,716,1128,663,437,2200,289731,1.517162471395881,794.0642291401874
1572,106,16044,78,714,481,1006,403,292,1390,117676,1.3801369863013702,497.6675597223512
1573,1584,16044,38,694,475,1090,437,396,1666,173052,1.1035353535353536,589.7329904287194
1574,1509,16044,34,683,522,1121,488,438,1852,213744,1.1141552511415524,655.7347024521426
1575,1629,16044,197,687,575,911,378,224,1204,84672,1.6875,439.38593514130605
1576,1621,6171,145,553,842,868,697,315,2024,219555,2.2126984126984133,764.8751532112937
1577,1092,6171,87,371,931,965,844,594,2876,501336,1.4208754208754208,1032.0717029354114
1578,1459,6171,689,668,790,827,101,159,520,16059,0.6352201257861635,188.36666371733614
1579,52,6171,140,435,886,988,746,553,2598,412538,1.349005424954792,928.6145594378758
1580,1164,6171,123,451,843,848,720,397,2234,285840,1.81360201511335,822.1976647984352
1581,540,6171,120,443,905,941,785,498,2566,390930,1.5763052208835342,929.6391773155863
1582,916,6171,124,477,922,941,798,464,2524,370272,1.7198275862068966,923.0926280715278
1583,508,19082,47,1072,280,1312,233,240,946,55920,0.9708333333333332,334.4981315343929
1584,1223,19082,66,979,572,1409,506,430,1872,217580,1.1767441860465115,664.0301197987935
1585,1473,19082,43,966,573,1407,530,441,1942,233730,1.2018140589569162,689.4787886512536
1586,781,19082,76,985,496,1392,420,407,1654,170940,1.031941031941032,584.8495533040955
1587,997,19082,41,968,411,1282,370,314,1368,116180,1.178343949044586,485.27930102158695
1588,1454,26659,85,620,389,849,304,229,1066,69616,1.3275109170305677,380.60084077679073
1589,1729,26659,154,603,354,844,200,241,882,48200,0.8298755186721992,313.1788626328412
1590,138,26659,124,671,320,743,196,72,536,14112,2.7222222222222223,208.806130178211
1591,1341,26659,216,648,421,829,205,181,772,37105,1.132596685082873,273.4702908909851
1592,858,26659,37,563,459,872,422,309,1462,130398,1.3656957928802589,523.034415693652
1593,149,26659,105,581,394,856,289,275,1128,79475,1.050909090909091,398.93107174047
1594,643,26659,49,581,412,875,363,294,1314,106722,1.2346938775510203,467.1241804916547
1595,763,19179,31,492,211,589,180,97,554,17460,1.855670103092784,204.47249203743763
1596,355,19179,42,489,211,589,169,100,538,16900,1.69,196.3695495742657
1597,1503,19179,56,506,210,583,154,77,462,11858,2.0,172.1772342674838
1598,42,4584,196,811,742,1225,546,414,1920,226044,1.318840579710145,685.2094570275574
1599,1389,4584,212,756,633,1274,421,518,1878,218078,0.8127413127413128,667.5065542749375
1600,1508,4584,128,737,484,1044,356,307,1326,109292,1.1596091205211727,470.0904168348893
1601,294,4584,250,867,573,1232,323,365,1376,117895,0.8849315068493151,487.3951169226052
1602,374,18269,149,561,354,647,205,86,582,17630,2.3837209302325584,222.3083444227859
1603,1304,18269,139,551,287,673,148,122,540,18056,1.213114754098361,191.80198122021577
1604,161,18269,128,530,371,673,243,143,772,34749,1.6993006993006994,281.95389694061686
1605,806,28831,31,528,79,563,48,35,166,1680,1.3714285714285714,59.405386961116584
1606,973,28831,34,528,54,540,20,12,64,240,1.6666666666666667,23.323807579381203
1607,531,28831,30,527,80,569,50,42,184,2100,1.1904761904761905,65.29931086925804
1608,1141,28831,26,528,79,566,53,38,182,2014,1.3947368421052628,65.21502894272147
1609,1138,28831,29,529,80,569,51,40,182,2040,1.275,64.81512169239521
1610,252,28831,29,531,81,562,52,31,166,1612,1.6774193548387095,60.53924347066124
1611,907,28831,27,542,56,561,29,19,96,551,1.5263157894736843,34.66987164671943
1612,518,1817,121,523,714,1008,593,485,2156,287605,1.222680412371134,766.0770196266169
1613,748,1817,371,533,683,880,312,347,1318,108264,0.8991354466858791,466.64011829245885
1614,190,1817,155,468,763,997,608,529,2274,321632,1.1493383742911154,805.9187303940764
1615,1274,1817,216,499,753,984,537,485,2044,260445,1.1072164948453609,723.5979546681983
1616,1650,1817,467,589,569,658,102,69,342,7038,1.4782608695652173,123.14625451064275
1617,338,1817,127,636,823,1002,696,366,2124,254736,1.901639344262295,786.3663268477358
1618,952,1817,425,552,598,926,173,374,1094,64702,0.4625668449197861,412.0740224765449
1619,744,1817,174,403,821,1034,647,631,2556,408257,1.0253565768621236,903.7532849179581
1620,128,32954,33,653,382,886,349,233,1164,81317,1.497854077253219,419.63079010005924
1621,191,32954,98,708,318,871,220,163,766,35860,1.3496932515337423,273.80467490530543
1622,957,32954,93,652,357,876,264,224,976,59136,1.1785714285714286,346.22536013411843
1623,874,32631,43,812,66,836,23,24,94,552,0.9583333333333334,33.24154027718932
1624,1513,32631,41,810,66,841,25,31,112,775,0.8064516129032258,39.824615503479755
1625,100,32631,40,809,67,841,27,32,118,864,0.84375,41.86884283091664
1626,1562,23031,227,287,308,405,81,118,398,9558,0.6864406779661016,143.1258187749506
1627,1508,23031,212,281,304,413,92,132,448,12144,0.696969696969697,160.89748288895012
1628,488,23031,215,288,311,414,96,126,444,12096,0.7619047619047619,158.40454538932903
1629,1350,23031,16,279,398,440,382,161,1086,61502,2.372670807453416,414.5419158541148
1630,1241,23031,236,290,352,362,116,72,376,8352,1.6111111111111112,136.5283853270081
1631,177,12215,90,987,143,1021,53,34,174,1802,1.5588235294117647,62.96824596572466
1632,1469,12215,95,983,148,1023,53,40,186,2120,1.325,66.40030120413611
1633,218,12215,80,984,147,1035,67,51,236,3417,1.3137254901960784,84.20213774008353
1634,993,12215,95,1004,128,1025,33,21,108,693,1.5714285714285714,39.11521443121589
1635,66,12215,86,986,146,1026,60,40,200,2400,1.5,72.11102550927978
1636,621,12215,86,985,147,1028,61,43,208,2623,1.4186046511627908,74.63243262818116
1637,46,32888,85,509,594,961,509,452,1922,230068,1.1261061946902655,680.7238794107343
1638,874,32888,65,532,610,922,545,390,1870,212550,1.3974358974358974,670.1678894127948
1639,1513,32888,28,432,679,976,651,544,2390,354144,1.1966911764705883,848.3731490329005
1640,1304,34339,107,552,426,896,319,344,1326,109736,0.9273255813953488,469.14496693452867
1641,1155,34339,106,572,370,843,264,271,1070,71544,0.9741697416974171,378.3345080745345
1642,1097,34339,26,568,343,886,317,318,1270,100806,0.9968553459119496,449.01336283010556
1643,1182,23115,190,442,415,676,225,234,918,52650,0.9615384615384616,324.6243983436858
1644,15,23115,151,389,538,677,387,288,1350,111456,1.34375,482.4033581972663
1645,27,23115,147,412,474,651,327,239,1132,78153,1.3682008368200838,405.0308630215727
1646,1549,23115,158,432,467,683,309,251,1120,77559,1.2310756972111554,398.0979778898657
1647,525,23115,174,419,394,647,220,228,896,50160,0.9649122807017544,316.83434157300564
1648,636,23115,108,393,524,691,416,298,1428,123968,1.3959731543624159,511.7225810925291
1649,576,23115,181,441,520,652,339,211,1100,71529,1.6066350710900474,399.30189080443887
1650,752,23115,131,374,540,708,409,334,1486,136606,1.2245508982035929,528.0501870087729
1651,1447,26263,135,235,411,465,276,230,1012,63480,1.2,359.2714850917061
1652,1283,26263,102,252,486,769,384,517,1802,198528,0.7427466150870407,644.0069875397315
1653,1454,26263,116,252,484,762,368,510,1756,187680,0.7215686274509804,628.9069883536039
1654,858,26263,71,214,494,799,423,585,2016,247455,0.7230769230769231,721.9099666855972
1655,647,26263,97,224,494,793,397,569,1932,225893,0.6977152899824253,693.808330881087
1656,31,26263,40,220,480,754,440,534,1948,234960,0.8239700374531835,691.921960917559
1657,952,23511,309,1218,689,1708,380,490,1740,186200,0.7755102040816326,620.0806399170998
1658,15,23511,186,1164,662,1660,476,496,1944,236096,0.9596774193548387,687.4532711392098
1659,1608,23511,98,1135,882,1704,784,569,2706,446096,1.3778558875219684,968.7192575767243
1660,68,23511,272,1160,841,1559,569,399,1936,227031,1.4260651629072685,694.9546747810249
1661,1483,23511,365,1195,664,1655,299,460,1518,137540,0.65,548.6355803263219
1662,1378,23511,203,1143,698,1685,495,542,2074,268290,0.9132841328413284,734.0224792198125
1663,957,23511,145,1140,704,1723,559,583,2284,325897,0.9588336192109777,807.6942490819159
1664,184,23511,170,1145,726,1721,556,576,2264,320256,0.9652777777777778,800.5697970820534
1665,576,23511,287,1201,763,1690,476,489,1930,232764,0.9734151329243352,682.4199586764737
1666,80,23511,413,1287,734,1510,321,223,1088,71583,1.4394618834080717,390.858030491891
1667,759,31700,125,217,739,724,614,507,2242,311298,1.2110453648915187,796.2694267645845
1668,648,31700,87,187,663,619,576,432,2016,248832,1.3333333333333333,720.0
1669,858,31700,52,135,833,779,781,644,2850,502964,1.2127329192546583,1012.2731844714647
1670,258,31700,133,224,554,687,421,463,1768,194923,0.9092872570194384,625.7875038701236
1671,1505,31700,167,263,628,656,461,393,1708,181173,1.173027989821883,605.7804882958843
1672,32,31700,97,186,516,619,419,433,1704,181427,0.9676674364896074,602.5363059600642
1673,203,31700,141,180,785,630,644,450,2188,289800,1.4311111111111108,785.6436851397713
1674,947,7010,35,439,296,812,261,373,1268,97353,0.6997319034852547,455.2471856036015
1675,752,7010,35,447,296,806,261,359,1240,93699,0.7270194986072424,443.8490734472699
1676,1133,7010,21,447,295,784,274,337,1222,92338,0.8130563798219584,434.3328216932264
1677,1281,7010,15,438,298,809,283,371,1308,104993,0.7628032345013477,466.6154733825272
1678,1435,7010,30,456,294,764,264,308,1144,81312,0.8571428571428571,405.65995612088705
1679,754,7010,80,453,291,586,211,133,688,28063,1.5864661654135341,249.41932563456265
1680,191,34957,59,990,118,1055,59,65,248,3835,0.9076923076923076,87.78382538941898
1681,1186,34957,64,983,120,1068,56,85,282,4760,0.6588235294117647,101.78899744078434
1682,1332,34957,66,978,119,1023,53,45,196,2385,1.1777777777777778,69.52697318307479
1683,1546,34957,58,982,121,1062,63,80,286,5040,0.7875,101.82828683622247
1684,525,34957,84,996,106,1048,22,52,148,1144,0.4230769230769231,56.462376853972415
1685,338,34957,64,1011,96,1023,32,12,88,384,2.6666666666666665,34.17601498127012
1686,1377,34957,80,994,114,1055,34,61,190,2074,0.5573770491803278,69.83552104767315
1687,255,31443,18,328,279,492,261,164,850,42804,1.5914634146341464,308.24827655641485
1688,1573,31443,82,335,287,482,205,147,704,30135,1.3945578231292517,252.25780463644728
1689,32,31443,18,350,292,487,274,137,822,37538,2.0,306.3413129174712
1690,697,31443,20,346,292,501,272,155,854,42160,1.7548387096774194,313.06389124266633
1691,1675,31443,19,340,291,504,272,164,872,44608,1.6585365853658536,317.6161204976851
1692,134,31443,28,335,277,500,249,165,828,41085,1.509090909090909,298.7072145094591
1693,1508,31443,25,343,282,494,257,151,816,38807,1.7019867549668874,298.0771712157776
1694,1196,31443,21,333,285,483,264,150,828,39600,1.76,303.63794229311986
1695,761,31443,165,355,282,478,117,123,480,14391,0.951219512195122,169.7586522095413
1696,831,28915,106,821,346,1019,240,198,876,47520,1.2121212121212122,311.1334118991401
1697,314,28915,140,825,304,1059,164,234,796,38376,0.7008547008547008,285.74814085134483
1698,1585,28915,129,844,282,1026,153,182,670,27846,0.8406593406593407,237.7666923688009
1699,1115,27587,20,411,579,817,559,406,1930,226954,1.376847290640394,690.8813212122615
1700,932,27587,18,402,588,827,570,425,1990,242250,1.3411764705882352,711.0028129339573
1701,1365,27587,206,493,397,782,191,289,960,55199,0.6608996539792388,346.4130482530934
1702,1534,27587,96,395,585,826,489,431,1840,210759,1.134570765661253,651.8297323688142
1703,841,27587,149,402,581,824,432,422,1708,182304,1.0236966824644549,603.9105894087303
1704,1367,27587,69,407,584,823,515,416,1862,214240,1.2379807692307692,662.027945029513
1705,1105,27587,130,395,587,817,457,422,1758,192854,1.0829383886255923,622.0393878204177
1706,881,27587,128,399,568,808,440,409,1698,179960,1.075794621026895,600.7337180481882
1707,924,27587,174,473,419,781,245,308,1106,75460,0.7954545454545454,393.55939831237674
1708,560,27587,188,533,486,792,298,259,1114,77182,1.1505791505791505,394.82274503883383
1709,1225,27587,86,402,536,803,450,401,1702,180450,1.1221945137157108,602.7445561761632
1710,526,4145,27,332,500,691,473,359,1664,169807,1.317548746518106,593.8097338373631
1711,969,4145,32,467,636,499,604,32,1272,19328,18.875,604.8470881140125
1712,972,4145,140,348,632,640,492,292,1568,143664,1.6849315068493151,572.1258602790124
1713,1024,4145,32,341,657,714,625,373,1996,233125,1.675603217158177,727.8420158248629
1714,1389,4145,119,334,622,788,503,454,1914,228362,1.1079295154185025,677.5876327088622
1715,439,4145,175,374,669,769,494,395,1778,195130,1.250632911392405,632.5037549295656
1716,1562,4163,92,706,234,852,142,146,576,20732,0.9726027397260274,203.66639388961548
1717,972,4163,96,715,225,832,129,117,492,15093,1.1025641025641026,174.1551032843999
1718,1508,4163,96,778,195,823,99,45,288,4455,2.2,108.74741376235114
1719,1506,4163,82,705,234,841,152,136,576,20672,1.1176470588235294,203.9607805437114
1720,1389,4163,88,794,213,848,125,54,358,6750,2.314814814814815,136.1653406708183
1721,1024,4163,100,786,216,833,116,47,326,5452,2.4680851063829787,125.15989773086265
1722,526,4163,76,708,217,853,141,145,572,20445,0.9724137931034482,202.25231766286387
1723,141,32,21,279,388,624,367,345,1424,126615,1.0637681159420291,503.7003077227569
1724,366,32,9,321,387,638,378,317,1390,119826,1.1924290220820188,493.3284909672256
1725,903,32,17,319,380,631,363,312,1350,113256,1.1634615384615383,478.65749759091835
1726,605,3281,51,278,298,494,247,216,926,53352,1.1435185185185186,328.12345237730267
1727,1245,3281,39,265,308,471,269,206,950,55414,1.305825242718447,338.8170597830044
1728,1089,3281,85,306,275,460,190,154,688,29260,1.2337662337662338,244.57309745759036
1729,66,19471,81,331,784,852,703,521,2448,366263,1.3493282149712091,875.0142855976695
1730,1604,19471,83,298,806,808,723,510,2466,368730,1.4176470588235297,884.7762428998645
1731,508,19471,105,255,759,856,654,601,2510,393054,1.0881863560732112,888.2099976919873
1732,997,19471,186,336,781,790,595,454,2098,270130,1.3105726872246697,748.4256810131518
1733,781,19471,103,364,775,855,672,491,2326,329952,1.3686354378818737,832.2649818417209
1734,1107,15352,265,858,775,1348,510,490,2000,249900,1.0408163265306123,707.2481884034769
1735,1418,15352,36,735,940,1533,904,798,3404,721392,1.1328320802005012,1205.827516687192
1736,387,15352,77,765,884,1459,807,694,3002,560058,1.1628242074927957,1064.370706098209
1737,785,15352,164,787,919,1386,755,599,2708,452245,1.2604340567612689,963.7561932356128
1738,1370,15352,73,733,852,1508,779,775,3108,603725,1.0051612903225806,1098.847578147215
1739,1351,34667,117,773,908,1196,791,423,2428,334593,1.8699763593380612,897.0005574134277
1740,161,34667,201,756,894,1165,693,409,2204,283437,1.6943765281173595,804.6924878486191
1741,918,34667,214,763,790,1116,576,353,1858,203328,1.631728045325779,675.562728397593
1742,1585,34667,218,793,851,1121,633,328,1922,207624,1.929878048780488,712.9326756433597
1743,663,34667,166,759,940,1281,774,522,2592,404028,1.4827586206896552,933.5737785520756
1744,1509,572,102,1165,907,1831,805,666,2942,536130,1.2087087087087087,1044.7875382105206
1745,1750,572,54,1118,827,1684,773,566,2678,437518,1.3657243816254416,958.0631503194348
1746,604,572,136,1224,637,1719,501,495,1992,247995,1.0121212121212122,704.2911329840807
1747,1686,572,82,1098,433,1770,351,672,2046,235872,0.5223214285714286,758.1457643487827
1748,984,572,72,1080,811,1807,739,727,2932,537253,1.016506189821183,1036.6532689380765
1749,1737,572,53,1068,877,1831,824,763,3174,628712,1.0799475753604193,1123.0071237530062
1750,1400,572,107,1097,695,1732,588,635,2446,373380,0.9259842519685041,865.4299509492378
1751,1585,572,98,1135,754,1769,656,634,2580,415904,1.0347003154574133,912.3003891263008
1752,555,572,90,1156,783,1827,693,671,2728,465003,1.0327868852459017,964.6190958093251
1753,119,24053,80,865,646,1146,566,281,1694,159046,2.0142348754448403,631.9153424312469
1754,794,24053,84,847,603,1161,519,314,1666,162966,1.6528662420382163,606.5945927882971
1755,832,24053,78,849,633,1161,555,312,1734,173160,1.7788461538461535,636.6859508423286
1756,375,23259,290,814,665,1128,375,314,1378,117750,1.1942675159235672,489.10223880084624
1757,1357,23259,193,805,716,1117,523,312,1670,163176,1.676282051282051,608.9934318200812
1758,710,23259,264,744,687,1185,423,441,1728,186543,0.9591836734693876,611.0728270836464
1759,982,23259,105,861,688,1106,583,245,1656,142835,2.379591836734694,632.3875394091822
1760,1159,23259,203,785,766,1162,563,377,1880,212251,1.493368700265252,677.5677087937412
1761,632,5471,37,1007,625,1432,588,425,2026,249900,1.3835294117647061,725.512922007596
1762,681,5471,295,1075,567,1399,272,324,1192,88128,0.8395061728395061,423.03664143901295
1763,947,5471,264,1054,498,1324,234,270,1008,63180,0.8666666666666667,357.2897983430257
1764,1432,5471,231,1101,457,1322,226,221,894,49946,1.0226244343891402,316.09650425147066
1765,523,5471,241,1045,508,1356,267,311,1156,83037,0.8585209003215434,409.89022920777217
1766,11,5471,294,1073,420,1302,126,229,710,28854,0.5502183406113537,261.37520922994975
1767,952,5471,314,1160,351,1232,37,72,218,2664,0.5138888888888888,80.95060222135473
1768,577,5471,272,1074,490,1328,218,254,944,55372,0.8582677165354331,334.72376670920755
1769,1338,5471,339,1050,470,1392,131,342,946,44802,0.3830409356725146,366.23080154459973
1770,1540,5471,257,1070,431,1298,174,228,804,39672,0.7631578947368421,286.81004166521086
1771,589,29018,96,274,583,582,487,308,1590,149996,1.5811688311688312,576.2230470920093
1772,1348,29018,106,283,521,661,415,378,1586,156870,1.0978835978835981,561.3457045350931
1773,1138,29018,94,272,506,568,412,296,1416,121952,1.391891891891892,507.30661340061397
1774,1728,18784,172,493,636,971,464,478,1884,221792,0.9707112970711296,666.1681469418963
1775,699,18784,108,505,614,929,506,424,1860,214544,1.1933962264150944,660.1605865242184
1776,367,18784,127,496,624,943,497,447,1888,222159,1.1118568232662192,668.4444629137113
1777,1243,260,99,779,462,999,363,220,1166,79860,1.65,424.46319039464424
1778,1692,260,107,740,428,1006,321,266,1174,85386,1.2067669172932332,416.8896736547932
1779,831,260,83,778,494,996,411,218,1258,89598,1.8853211009174309,465.2364989980902
1780,1183,29174,68,969,222,1079,154,110,528,16940,1.4,189.25115587493778
1781,577,29174,67,976,211,1077,144,101,490,14544,1.4257425742574257,175.88916964952674
1782,852,29174,64,982,222,1076,158,94,504,14852,1.680851063829787,183.84776310850236
1783,10,29174,69,978,201,1088,132,110,484,14520,1.2,171.8254928699464
1784,999,29174,60,976,221,1093,161,117,556,18837,1.376068376068376,199.0226117806718
1785,744,29164,105,322,713,906,608,584,2384,355072,1.0410958904109588,843.0421104547506
1786,748,29164,133,314,421,822,288,508,1592,146304,0.5669291338582677,583.958902663535
1787,239,29164,125,314,829,1094,704,780,2968,549120,0.9025641025641026,1050.7216567673859
1788,1183,29164,47,325,885,1089,838,764,3204,640232,1.0968586387434556,1133.9929453043349
1789,852,29164,65,343,794,1154,729,811,3080,591219,0.8988902589395807,1090.4870471491167
1790,943,29164,68,316,754,1153,686,837,3046,574182,0.8195937873357229,1082.2037700913816
1791,411,29164,117,336,375,485,258,149,814,38442,1.7315436241610738,297.9345565724124
1792,577,29164,108,317,772,1130,664,813,2954,539832,0.8167281672816729,1049.6975754949613
1793,1311,26374,173,586,642,824,469,238,1414,111622,1.9705882352941175,525.9325051753314
1794,1323,26374,84,509,627,854,543,345,1776,187335,1.5739130434782609,643.3303972299149
1795,1605,26374,176,529,605,787,429,258,1374,110682,1.662790697674419,500.6046344172215
1796,795,26374,159,557,232,816,73,259,664,18907,0.28185328185328185,269.09106265351886
1797,1268,26374,160,605,603,862,443,257,1400,113851,1.7237354085603114,512.1503685442392
1798,1643,26374,167,509,653,720,486,211,1394,102546,2.303317535545024,529.827330363393
1799,452,26374,205,681,282,834,77,153,460,11781,0.5032679738562091,171.283390905248
1800,1707,26374,209,519,585,816,376,297,1346,111672,1.2659932659932658,479.15028957520207
1801,1703,26374,183,536,577,853,394,317,1422,124898,1.2429022082018928,505.69259436934607
1802,181,26374,166,536,649,826,483,290,1546,140070,1.6655172413793105,563.3728782964263
1803,1225,26374,170,582,596,790,426,208,1268,88608,2.0480769230769234,474.06750574153466
1804,878,26374,179,536,604,794,425,258,1366,109650,1.6472868217054264,497.1810535408605
1805,115,26374,174,538,597,816,423,278,1402,117594,1.5215827338129495,506.1748709685221
1806,567,26374,140,574,488,782,348,208,1112,72384,1.6730769230769231,405.4232356439379
1807,1114,26374,197,529,617,806,420,277,1394,116340,1.516245487364621,503.11927015370816
1808,119,26374,152,603,561,767,409,164,1146,67076,2.4939024390243905,440.65519400093314
1809,1007,32004,146,952,553,1324,407,372,1558,151404,1.0940860215053765,551.3918751668363
1810,335,32004,140,813,551,1450,411,637,2096,261807,0.6452119309262166,758.0831089003368
1811,1654,32004,188,955,464,1371,276,416,1384,114816,0.6634615384615384,499.2314092682871
1812,1281,32004,127,717,581,1446,454,729,2366,330966,0.6227709190672154,858.8113879077291
1813,689,32004,125,795,567,1443,442,648,2180,286416,0.6820987654320988,784.3902090158954
1814,191,32004,141,904,425,1333,284,429,1426,121836,0.662004662004662,514.4871232596595
1815,525,32004,238,980,490,1428,252,448,1400,112896,0.5625,514.0116730192029
1816,957,32004,138,883,496,1364,358,481,1678,172198,0.7442827442827443,599.6040360104324
1817,247,23092,90,848,128,895,38,47,170,1786,0.8085106382978723,60.440052945046304
1818,1508,23092,67,835,135,901,68,66,268,4488,1.0303030303030305,94.76286192385707
1819,592,23092,61,831,138,901,77,70,294,5390,1.1,104.06248123122954
1820,805,23092,80,845,139,893,59,48,214,2832,1.2291666666666667,76.05918747922567
1821,761,23092,71,841,135,901,64,60,248,3840,1.0666666666666669,87.72684879784524
1822,140,23092,75,840,145,901,70,61,262,4270,1.147540983606557,92.84934033152847
1823,1500,23092,65,842,133,901,68,59,254,4012,1.152542372881356,90.02777349240623
1824,971,23092,66,834,137,896,71,62,266,4402,1.1451612903225807,94.26027795418386
1825,411,29182,118,1012,356,1176,238,164,804,39032,1.451219512195122,289.03287010303865
1826,852,29182,82,979,397,1198,315,219,1068,68985,1.4383561643835616,383.64827641995214
1827,10,29182,139,995,391,1190,252,195,894,49140,1.2923076923076924,318.6361561405108
1828,1183,29182,124,985,369,1187,245,202,894,49490,1.2128712871287128,317.5358247505311
1829,952,29182,134,1005,347,1202,213,197,820,41961,1.0812182741116751,290.1344515909822
1830,1684,32415,40,238,399,511,359,273,1264,98007,1.3150183150183148,451.00997771667977
1831,656,32415,63,228,427,539,364,311,1350,113204,1.1704180064308682,478.766122443934
1832,874,32415,55,235,400,534,345,299,1288,103155,1.1538461538461535,456.5369645494218
1833,496,13832,147,362,317,653,170,291,922,49470,0.584192439862543,337.01780368401904
1834,654,13832,180,380,293,590,113,210,646,23730,0.5380952380952381,238.47222060441337
1835,1739,13832,148,351,330,659,182,308,980,56056,0.5909090909090909,357.7541054970579
1836,552,13832,83,361,346,656,263,295,1116,77585,0.8915254237288136,395.2138661535043
1837,449,13832,163,466,167,486,4,20,48,80,0.2,20.396078054371138
1838,1466,13832,157,409,327,618,170,209,758,35530,0.8133971291866029,269.40861159213154
1839,315,13832,188,378,298,636,110,258,736,28380,0.4263565891472868,280.471032372329
1840,161,13832,144,373,334,642,190,269,918,51110,0.7063197026022305,329.3341767870441
1841,1299,13832,159,361,326,459,167,98,530,16366,1.7040816326530612,193.63109254456012
1842,1308,13832,35,352,394,652,359,300,1318,107700,1.1966666666666668,467.8471972770597
1843,906,22391,47,527,328,663,281,136,834,38216,2.0661764705882355,312.18103722039234
1844,89,22391,145,524,300,661,155,137,584,21235,1.131386861313869,206.86710710018642
1845,653,22391,63,535,307,662,244,127,742,30988,1.921259842519685,275.0727176584403
1846,809,22391,40,484,324,670,284,186,940,52824,1.5268817204301075,339.4878495616596
1847,1200,22391,179,575,243,631,64,56,240,3584,1.1428571428571428,85.0411665018772
1848,91,22391,62,527,337,647,275,120,790,33000,2.2916666666666665,300.04166377354994
1849,422,22391,20,517,348,667,328,150,956,49200,2.1866666666666665,360.67159577654576
1850,1671,27396,68,795,847,1575,779,780,3118,607620,0.9987179487179488,1102.3796986519662
1851,1198,27396,100,807,831,1542,731,735,2932,537285,0.9945578231292516,1036.6223999123306
1852,1206,27396,32,799,810,1510,778,711,2978,553158,1.0942334739803097,1053.9473421381165
1853,1702,20930,143,681,331,871,188,190,756,35720,0.9894736842105264,267.2901045680517
1854,1272,20930,126,645,334,950,208,305,1026,63440,0.6819672131147541,369.173400992
1855,886,20930,38,659,333,953,295,294,1178,86730,1.0034013605442176,416.4864943788694
1856,168,20930,91,645,356,940,265,295,1120,78175,0.8983050847457628,396.547601177967
1857,1476,20930,174,761,294,841,120,80,400,9600,1.5,144.22205101855957
1858,1321,20930,152,654,355,894,203,240,886,48720,0.8458333333333333,314.33898899118446
1859,1573,27005,88,1000,416,1152,328,152,960,49856,2.1578947368421053,361.5079528862401
1860,305,27005,154,1018,422,1148,268,130,796,34840,2.0615384615384613,297.8657415682441
1861,1286,27005,71,1032,390,1151,319,119,876,37961,2.6806722689075633,340.4732001200682
1862,1386,27005,56,955,415,1233,359,278,1274,99802,1.29136690647482,454.0539615508271
1863,45,27005,74,1012,341,1177,267,165,864,44055,1.6181818181818182,313.86939959161356
1864,651,27005,74,1082,222,1151,148,69,434,10212,2.1449275362318843,163.29421300217592
1865,1284,27005,93,1007,417,1191,324,184,1016,59616,1.7608695652173914,372.60166397910785
1866,140,27005,58,991,252,1202,194,211,810,40934,0.919431279620853,286.6304240655552
1867,1498,27005,72,1015,425,1155,353,140,986,49420,2.521428571428572,379.74860105074777
1868,146,27005,70,1059,317,1213,247,154,802,38038,1.6038961038961042,291.0755915565577
1869,1448,27005,74,1015,419,1228,345,213,1116,73485,1.6197183098591552,405.4552996324009
1870,943,29141,91,877,215,1003,124,126,500,15624,0.984126984126984,176.7823520603796
1871,577,29141,87,884,215,987,128,103,462,13184,1.2427184466019416,164.2954655491137
1872,239,29141,66,856,215,976,149,120,538,17880,1.2416666666666667,191.31387822110554
1873,411,29141,80,881,146,991,66,110,352,7260,0.6,128.2809416865966
1874,852,29141,49,886,214,995,165,109,548,17985,1.5137614678899085,197.75237040298657
1875,744,29141,76,881,213,991,137,110,494,15070,1.2454545454545454,175.6957597667058
1876,1183,29141,81,866,203,1011,122,145,534,17690,0.8413793103448276,189.49670181826386
1877,1225,27571,101,824,442,998,341,174,1030,59334,1.9597701149425288,382.8276374558138
1878,1115,27571,95,817,460,1033,365,216,1162,78840,1.6898148148148149,424.1238026803023
1879,1367,27571,82,794,468,1024,386,230,1232,88780,1.6782608695652177,449.3283877076987
1880,917,10727,78,522,423,757,345,235,1160,81075,1.4680851063829787,417.43262929483603
1881,660,10727,64,520,404,726,340,206,1092,70040,1.6504854368932038,397.53741962235455
1882,831,10727,24,491,442,744,418,253,1342,105754,1.6521739130434785,488.6031109192818
1883,884,33081,82,416,419,694,337,278,1230,93686,1.212230215827338,436.86725672680024
1884,58,33081,168,426,348,660,180,234,828,42120,0.7692307692307693,295.22195040342103
1885,934,33081,109,430,411,692,302,262,1128,79124,1.1526717557251909,399.8099548535529
1886,1270,33081,243,478,361,661,118,183,602,21594,0.644808743169399,217.74526401279087
1887,937,33081,172,453,360,658,188,205,786,38540,0.9170731707317074,278.15283568570715
1888,1508,34508,35,941,309,1103,274,162,872,44388,1.6913580246913582,318.30802691732424
1889,94,34508,57,926,263,1091,206,165,742,33990,1.2484848484848483,263.9337037969952
1890,292,34508,30,915,268,1099,238,184,844,43792,1.2934782608695652,300.83217912982644
1891,200,34508,33,926,272,1100,239,174,826,41586,1.3735632183908046,295.62983611266304
1892,814,34508,96,930,265,1096,169,166,670,28054,1.0180722891566265,236.8902699563661
1893,138,34508,97,1015,234,1101,137,86,446,11782,1.5930232558139534,161.75598906995685
1894,765,34508,102,898,358,1103,256,205,922,52480,1.2487804878048778,327.96493715029965
1895,148,34508,63,957,285,1094,222,137,718,30414,1.6204379562043796,260.8696992753279
1896,1674,34508,88,951,262,1083,174,132,612,22968,1.318181818181818,218.40329667841556
1897,161,14215,55,939,216,1041,161,102,526,16422,1.5784313725490196,190.59118552545917
1898,1086,14215,88,968,127,1014,39,46,170,1794,0.8478260869565217,60.30754513325841
1899,383,14215,82,961,214,1025,132,64,392,8448,2.0625,146.696966567138
1900,552,14215,58,943,206,1034,148,91,478,13468,1.6263736263736264,173.738308959193
1901,1684,14215,64,948,198,1036,134,88,444,11792,1.5227272727272727,160.31219541881399
1902,1681,14215,98,1013,99,1014,1,1,4,1,1.0,1.4142135623730951
1903,1514,14215,85,988,189,1023,104,35,278,3640,2.9714285714285715,109.73149046650191
1904,1159,14215,55,942,215,1039,160,97,514,15520,1.649484536082474,187.1069213043708
1905,664,14215,53,937,215,1040,162,103,530,16686,1.5728155339805825,191.9713520294109
1906,423,4752,82,778,136,799,54,21,150,1134,2.571428571428572,57.9396237474839
1907,819,4752,91,773,134,804,43,31,148,1333,1.3870967741935485,53.009433122794285
1908,1021,4752,88,775,129,808,41,33,148,1353,1.2424242424242424,52.630789467763066
1909,969,4752,107,783,124,798,17,15,64,255,1.1333333333333333,22.67156809750927
1910,1389,4752,83,770,142,814,59,44,206,2596,1.3409090909090908,73.60027173862879
1911,696,4752,93,781,130,809,37,28,130,1036,1.3214285714285714,46.400431032480725
1912,1508,4752,83,762,127,804,44,42,172,1848,1.0476190476190477,60.8276253029822
1913,1591,14685,37,828,67,853,30,25,110,750,1.2,39.05124837953327
1914,1684,14685,37,830,70,859,33,29,124,957,1.137931034482759,43.93176527297759
1915,664,14685,33,831,68,857,35,26,122,910,1.3461538461538465,43.60045871318328
1916,1589,14685,36,829,70,857,34,28,124,952,1.2142857142857142,44.04543109109048
1917,867,14685,35,832,75,858,40,26,132,1040,1.5384615384615383,47.70744176750625
1918,552,14685,46,830,70,848,24,18,84,432,1.3333333333333333,30.0
1919,1681,14685,34,828,78,858,44,30,148,1320,1.4666666666666666,53.25410782277739
1920,383,14685,56,835,67,844,11,9,40,99,1.2222222222222223,14.212670403551895
1921,1159,14685,58,830,68,843,10,13,46,130,0.7692307692307693,16.401219466856727
1922,1086,14685,60,830,65,841,5,11,32,55,0.4545454545454545,12.083045973594572
1923,699,18796,33,489,246,677,213,188,802,40044,1.1329787234042554,284.1003343891027
1924,297,18796,35,467,287,677,252,210,924,52920,1.2,328.0304863880795
1925,1728,18796,47,474,281,664,234,190,848,44460,1.2315789473684209,301.4232904073605
1926,952,33551,61,970,162,1092,101,122,446,12322,0.8278688524590164,158.38244852255568
1927,1232,33551,62,972,168,1087,106,115,442,12190,0.9217391304347826,156.40012787718558
1928,957,33551,63,966,167,1089,104,123,454,12792,0.8455284552845529,161.07451691686057
1929,525,33551,53,974,152,1060,99,86,370,8514,1.1511627906976745,131.13733259449805
1930,21,33551,60,978,165,1086,105,108,426,11340,0.9722222222222222,150.6286825275983
1931,128,33551,46,961,171,1095,125,134,518,16750,0.9328358208955224,183.25119372053214
1932,552,15092,120,300,352,513,232,213,890,49416,1.0892018779342725,314.9492022533158
1933,1587,15092,142,302,355,503,213,201,828,42813,1.0597014925373134,292.86515668477875
1934,1681,15092,135,298,357,500,222,202,848,44844,1.099009900990099,300.1466308323317
1935,1684,15092,137,301,356,525,219,224,886,49056,0.9776785714285714,313.2682556532021
1936,1581,15092,166,307,364,525,198,218,832,43164,0.908256880733945,294.4961799412685
1937,3,12975,144,962,556,1128,412,166,1156,68392,2.4819277108433737,444.1846462902562
1938,391,12975,144,949,553,1158,409,209,1236,85481,1.9569377990430623,459.30599821905224
1939,1107,12975,170,928,501,1167,331,239,1140,79109,1.3849372384937235,408.2670694533175
1940,191,35223,369,599,495,858,126,259,770,32634,0.4864864864864865,288.0225685601738
1941,1377,35223,392,626,503,815,111,189,600,20979,0.5873015873015873,219.18485349129398
1942,895,35223,308,527,697,917,389,390,1558,151710,0.9974358974358974,550.8366363995772
1943,1420,35223,332,581,534,887,202,306,1016,61812,0.6601307189542484,366.6606060105176
1944,1186,35223,289,508,673,972,384,464,1696,178176,0.8275862068965517,602.2889671909987
1945,1546,35223,322,591,636,854,314,263,1154,82582,1.193916349809886,409.59125967237145
1946,1712,35223,387,599,431,685,44,86,260,3784,0.5116279069767442,96.60227740586657
1947,1332,35223,300,557,505,771,205,214,838,43870,0.9579439252336448,296.346081465573
1948,995,34114,52,1058,196,1157,144,99,486,14256,1.4545454545454546,174.7483905505284
1949,1222,34114,118,1060,177,1155,59,95,308,5605,0.6210526315789474,111.83022847155415
1950,327,34114,55,1058,200,1166,145,108,506,15660,1.3425925925925926,180.8009955724802
1951,1316,34114,124,1063,180,1158,56,95,302,5320,0.5894736842105263,110.27692415006868
1952,929,34114,67,1064,198,1139,131,75,412,9825,1.7466666666666666,150.95032295427526
1953,937,34114,106,1062,185,1151,79,89,336,7031,0.8876404494382022,119.00420160649792
1954,318,34114,120,1065,196,1138,76,73,298,5548,1.0410958904109588,105.38026380684383
1955,391,34114,57,1055,196,1153,139,98,474,13622,1.4183673469387754,170.07351351694948
1956,925,34114,54,1054,197,1154,143,100,486,14300,1.43,174.49641830135081
1957,1517,19633,95,819,254,955,159,136,590,21624,1.1691176470588236,209.2295390235327
1958,1210,19633,77,800,347,1021,270,221,982,59670,1.2217194570135748,348.91402952589914
1959,711,19633,106,832,198,914,92,82,348,7544,1.1219512195121952,123.23960402403117
1960,1516,19633,74,786,278,1010,204,224,856,45696,0.9107142857142856,302.9719458959856
1961,379,19633,37,793,344,1011,307,218,1050,66926,1.408256880733945,376.52755543253403
1962,1303,22604,343,925,686,1270,343,345,1376,118335,0.9942028985507246,486.4915209949707
1963,55,22604,349,952,674,1251,325,299,1248,97175,1.0869565217391304,441.61748153803876
1964,1163,22604,345,971,674,1242,329,271,1200,89159,1.2140221402214022,426.2417154620134
1965,598,9655,107,898,363,1237,256,339,1190,86784,0.7551622418879056,424.8023069617207
1966,1588,9655,107,939,354,1218,247,279,1052,68913,0.8853046594982079,372.6258176777342
1967,1210,9655,77,900,338,1265,261,365,1252,95265,0.7150684931506849,448.71594578307554
1968,1225,27559,67,782,401,996,334,214,1096,71476,1.5607476635514017,396.67619036186176
1969,1115,27559,59,786,405,985,346,199,1090,68854,1.7386934673366834,399.1453369388148
1970,932,27559,70,804,414,999,344,195,1078,67080,1.7641025641025638,395.42508772206145
1971,1558,19558,75,758,985,1357,910,599,3018,545090,1.5191986644407345,1089.4498611684708
1972,295,19558,97,855,983,1254,886,399,2570,353514,2.2205513784461157,971.6979983513396
1973,1722,19558,133,816,974,1203,841,387,2456,325467,2.1731266149870803,925.7699498255492
1974,805,21997,133,863,399,1098,266,235,1002,62510,1.1319148936170214,354.9380227589036
1975,1508,21997,111,862,356,1155,245,293,1076,71785,0.8361774744027304,381.93454936677307
1976,93,21997,83,867,331,1154,248,287,1070,71176,0.8641114982578397,379.30594511554915
1977,1602,1490,31,445,68,483,37,38,150,1406,0.9736842105263158,53.03772242470448
1978,279,1490,29,442,67,479,38,37,150,1406,1.027027027027027,53.03772242470448
1979,119,1490,30,447,68,476,38,29,134,1102,1.3103448275862069,47.80167361086848
1980,1319,9199,86,815,318,1054,232,239,942,55448,0.9707112970711296,333.08407347094817
1981,1047,9199,96,809,279,1056,183,247,860,45201,0.7408906882591093,307.405269961333
1982,1266,9199,75,815,291,1060,216,245,922,52920,0.8816326530612245,326.62057497959313
1983,993,9199,67,824,292,994,225,170,790,38250,1.3235294117647058,282.00177304407146
1984,387,9199,80,809,309,1045,229,236,930,54044,0.9703389830508474,328.8419073050149
1985,386,9199,132,836,231,933,99,97,392,9603,1.0206185567010309,138.6001443000692
1986,768,17415,194,694,602,1145,408,451,1718,184008,0.9046563192904656,608.1652735893426
1987,1684,17415,239,703,614,1135,375,432,1614,162000,0.8680555555555556,572.0568153601529
1988,1592,17415,247,737,590,1167,343,430,1546,147490,0.7976744186046512,550.0445436507847
1989,676,13260,160,875,407,1045,247,170,834,41990,1.4529411764705882,299.84829497597616
1990,1046,13260,67,748,501,1069,434,321,1510,139314,1.3520249221183798,539.8120043126125
1991,1037,13260,187,746,500,1065,313,319,1264,99847,0.9811912225705328,446.9116243733206
1992,1170,13260,128,755,462,1087,334,332,1332,110888,1.0060240963855422,470.9352397092407
1993,1322,13260,193,745,426,1062,233,317,1100,73861,0.7350157728706624,393.4183523934795
1994,592,20476,46,485,790,1199,744,714,2916,531216,1.0420168067226891,1031.1799067088148
1995,1145,20476,33,482,784,1210,751,728,2958,546728,1.0315934065934067,1045.9373786226402
1996,1557,20476,65,485,756,1093,691,608,2598,420128,1.1365131578947372,920.4048022473589
1997,128,33651,21,407,995,993,974,586,3120,570764,1.6621160409556317,1136.6934503198302
1998,952,33651,617,431,764,839,147,408,1110,59976,0.3602941176470588,433.67384057607165
1999,951,33651,69,459,973,973,904,514,2836,464656,1.7587548638132295,1039.909611456688
2000,410,33651,89,441,843,959,754,518,2544,390572,1.4555984555984556,914.7895932945455
2001,415,33651,369,500,877,809,508,309,1634,156972,1.6440129449838188,594.596501839693
2002,957,33651,99,447,851,976,752,529,2562,397808,1.4215500945179584,919.4264516534207
2003,1132,33651,179,455,959,933,780,478,2516,372840,1.6317991631799162,914.8136422244696
2004,1191,33651,332,624,673,883,341,259,1200,88319,1.3166023166023166,428.20789343495295
2005,1380,33651,30,426,993,996,963,570,3066,548910,1.6894736842105262,1119.0482563321386
2006,692,4570,30,605,94,644,64,39,206,2496,1.641025641025641,74.94664769020693
2007,197,4570,69,606,99,636,30,30,120,900,1.0,42.42640687119285
2008,480,4570,70,605,98,634,28,29,114,812,0.9655172413793104,40.311288741492746
2009,365,4570,33,608,97,645,64,37,202,2368,1.7297297297297298,73.92563831310488
2010,1508,4570,36,611,58,647,22,36,116,792,0.6111111111111112,42.190046219457976
2011,1389,4570,30,607,71,649,41,42,166,1722,0.9761904761904762,58.69412236331676
2012,1144,4570,33,609,99,644,66,35,202,2310,1.8857142857142857,74.70609078247904
2013,831,28965,44,369,348,530,304,161,930,48944,1.8881987577639752,344.0014534853014
2014,1026,28965,26,348,392,553,366,205,1142,75030,1.7853658536585366,419.5008939203825
2015,1585,28965,61,355,296,534,235,179,828,42065,1.3128491620111729,295.4081921680575
2016,1664,31045,201,908,346,1118,145,210,710,30450,0.6904761904761905,255.1960031034969
2017,1572,31045,185,813,681,1276,496,463,1918,229648,1.0712742980561556,678.516764715508
2018,649,31045,267,925,576,1175,309,250,1118,77250,1.236,397.46823772472686
2019,1446,31045,259,926,646,1111,387,185,1144,71595,2.091891891891892,428.94521794746703
2020,433,31045,188,898,616,1113,428,215,1286,92020,1.990697674418605,478.9665959124916
2021,1671,31045,214,906,681,1173,467,267,1468,124689,1.7490636704119853,537.9386582129973
2022,363,31045,213,890,650,1138,437,248,1370,108376,1.7620967741935485,502.46691433367033
2023,1727,31045,188,858,702,1259,514,401,1830,206114,1.2817955112219452,651.9179396212379
2024,859,31045,111,807,871,1337,760,530,2580,402800,1.4339622641509433,926.5527507918802
2025,1222,31515,54,727,97,777,43,50,186,2150,0.86,65.94694837519019
2026,1706,31515,51,727,111,782,60,55,230,3300,1.0909090909090908,81.39410298049853
2027,886,31515,54,726,104,776,50,50,200,2500,1.0,70.71067811865476
2028,1068,30242,204,1084,532,1241,328,157,970,51496,2.0891719745222934,363.63855681156804
2029,483,30242,266,1113,538,1255,272,142,828,38624,1.9154929577464788,306.8354607929142
2030,1508,30242,313,1122,551,1272,238,150,776,35700,1.586666666666667,281.3254343282882
2031,145,30242,385,1134,500,1231,115,97,424,11155,1.1855670103092784,150.4460036026215
2032,147,30242,197,1018,660,1345,463,327,1580,151401,1.4159021406727832,566.83154464091
2033,1496,30242,312,1115,598,1284,286,169,910,48334,1.6923076923076923,332.20024081869656
2034,590,30242,322,1115,587,1284,265,169,868,44785,1.5680473372781063,314.30240215435833
2035,491,30242,291,1107,538,1243,247,136,766,33592,1.8161764705882355,281.966310044303
2036,1631,13675,270,915,524,1131,254,216,940,54864,1.1759259259259258,333.4246541574273
2037,314,13675,662,1292,665,1294,3,2,10,6,1.5,3.605551275463989
2038,497,13675,238,858,750,1298,512,440,1904,225280,1.1636363636363636,675.088142393273
2039,1095,13675,233,867,755,1309,522,442,1928,230724,1.1809954751131222,683.9941520217844
2040,161,13675,207,865,694,1292,487,427,1828,207949,1.1405152224824355,647.686652633818
2041,831,13675,165,870,750,1286,585,416,2002,243360,1.40625,717.8307599984832
2042,221,4992,185,788,256,878,71,90,322,6390,0.7888888888888889,114.63420083029322
2043,931,4992,55,785,264,881,209,96,610,20064,2.177083333333333,229.99347816840373
2044,567,4992,59,799,250,887,191,88,558,16808,2.1704545454545454,210.2974084481309
2045,1116,4992,180,789,279,892,99,103,404,10197,0.9611650485436892,142.86357128393507
2046,505,4992,176,788,221,887,45,99,288,4455,0.4545454545454545,108.74741376235114
2047,886,4992,71,807,113,879,42,72,228,3024,0.5833333333333334,83.35466393669883
2048,560,17591,58,595,226,710,168,115,566,19320,1.4608695652173913,203.59027481684876
2049,512,17591,66,600,213,718,147,118,530,17346,1.2457627118644068,188.50198937942272
2050,389,17591,76,604,197,718,121,114,470,13794,1.0614035087719298,166.24379687675568
2051,1686,8713,42,670,655,1219,613,549,2324,336537,1.116575591985428,822.9033965174771
2052,448,8713,111,726,669,1182,558,456,2028,254448,1.2236842105263157,720.6247289678588
2053,265,8713,40,598,716,1249,676,651,2654,440076,1.0384024577572966,938.4972029793163
2054,866,8713,487,827,690,1071,203,244,894,49532,0.8319672131147541,317.40352865083275
2055,154,8713,54,703,723,1183,669,480,2298,321120,1.39375,823.383871593317
2056,1685,8713,92,654,720,1243,628,589,2434,369892,1.0662139219015279,860.9907084283778
2057,311,8713,94,661,708,1219,614,558,2344,342612,1.1003584229390682,829.6746350226696
2058,213,8713,38,653,835,1233,797,580,2754,462260,1.3741379310344828,985.7022877116599
2059,161,8713,47,627,687,1228,640,601,2482,384640,1.064891846921797,877.9527322128453
2060,252,29669,273,533,598,950,325,417,1484,135525,0.7793764988009593,528.6908359334404
2061,1453,29669,240,534,610,975,370,441,1622,163170,0.8390022675736961,575.6570159391788
2062,531,29669,257,517,606,963,349,446,1590,155654,0.7825112107623319,566.3188148031107
2063,115,27762,20,247,729,809,709,562,2542,398458,1.2615658362989324,904.7237147328459
2064,1603,27762,25,243,817,802,792,559,2702,442728,1.4168157423971377,969.4044563545187
2065,273,27762,64,274,722,785,658,511,2338,336238,1.2876712328767124,833.1176387521753
2066,1601,1451,513,448,721,644,208,196,808,40768,1.0612244897959184,285.79713084634
2067,1602,1451,126,200,755,665,629,465,2188,292485,1.3526881720430108,782.2186395119974
2068,119,1451,89,275,710,610,621,335,1912,208035,1.8537313432835818,705.5962018038363
2069,935,1451,12,172,797,693,785,521,2612,408985,1.5067178502879084,942.1602836035916
2070,1607,1451,65,218,786,691,721,473,2388,341033,1.5243128964059196,862.3050504316903
2071,886,1451,56,257,783,657,727,400,2254,290800,1.8175,829.7764759258965
2072,1562,22393,52,511,431,873,379,362,1482,137198,1.0469613259668509,524.1039973135103
2073,653,22393,24,421,488,863,464,442,1812,205088,1.0497737556561086,640.8275899179123
2074,93,22393,35,453,476,844,441,391,1664,172431,1.1278772378516624,589.3742444321774
2075,91,22393,52,555,463,827,411,272,1366,111792,1.5110294117647058,492.8539337369643
2076,422,22393,64,743,340,803,276,60,672,16560,4.6,282.44645510255566
2077,1718,19771,97,758,525,1095,428,337,1530,144236,1.2700296735905046,544.7504015602008
2078,1717,19771,101,745,493,1114,392,369,1522,144648,1.0623306233062328,538.3539727725616
2079,683,19771,64,750,549,1116,485,366,1702,177510,1.325136612021858,607.6026662219316
2080,1221,20270,106,463,422,745,316,282,1196,89112,1.1205673758865249,423.5327614246624
2081,1480,20270,113,503,421,743,308,240,1096,73920,1.2833333333333334,390.4663877979768
2082,174,20270,101,469,423,742,322,273,1190,87906,1.1794871794871795,422.15281593280883
2083,227,20270,71,475,417,734,346,259,1210,89614,1.335907335907336,432.20018509945135
2084,1362,20270,146,538,380,698,234,160,788,37440,1.4625,283.47133893923035
2085,1321,20270,108,492,422,684,314,192,1012,60288,1.6354166666666667,368.0489097932502
2086,903,14067,197,154,738,641,541,487,2056,263467,1.11088295687885,727.9079612148778
2087,909,14067,210,159,794,746,584,587,2342,342808,0.9948892674616696,828.0247580839597
2088,1389,14067,73,135,780,757,707,622,2658,439754,1.1366559485530547,941.6650147478136
2089,1207,14067,107,166,875,751,768,585,2706,449280,1.3128205128205128,965.4268486011771
2090,1241,14067,196,166,790,736,594,570,2328,338580,1.0421052631578946,823.24722896588
2091,1508,14067,123,169,809,748,686,579,2530,397194,1.184801381692573,897.6842429273224
2092,1383,14067,162,176,782,757,620,581,2402,360220,1.0671256454388984,849.6828820212868
2093,468,27233,47,766,540,1356,493,590,2166,290870,0.8355932203389831,768.8621462915182
2094,952,27233,451,791,456,796,5,5,20,25,1.0,7.0710678118654755
2095,1011,27233,64,743,69,748,5,5,20,25,1.0,7.0710678118654755
2096,1059,27233,33,735,504,1365,471,630,2202,296730,0.7476190476190476,786.6009153312752
2097,470,27233,105,773,497,1353,392,580,1944,227360,0.6758620689655173,700.0457127931004
2098,853,27233,295,779,445,919,150,140,580,21000,1.0714285714285714,205.1828452868319
2099,191,27233,217,828,489,1306,272,478,1500,130016,0.5690376569037657,549.9709083215221
2100,328,7555,61,1034,104,1064,43,30,146,1290,1.4333333333333331,52.43090691567332
2101,502,7555,60,1036,101,1064,41,28,138,1148,1.4642857142857142,49.64876634922564
2102,1698,7555,58,1031,99,1066,41,35,152,1435,1.1714285714285717,53.907327887774215
2103,1180,23961,384,724,880,1438,496,714,2420,354144,0.6946778711484594,869.3744877784256
2104,22,23961,43,695,1046,1430,1003,735,3476,737205,1.364625850340136,1243.4765779860913
2105,26,23961,402,749,929,1423,527,674,2402,355198,0.7818991097922848,855.5729074719466
2106,952,23961,449,756,917,1312,468,556,2048,260208,0.8417266187050358,726.7461730205396
2107,1493,23961,35,724,925,1442,890,718,3216,639020,1.2395543175487465,1143.513882731644
2108,15,23961,338,724,917,1417,579,693,2544,401247,0.8354978354978355,903.0448493845696
2109,1238,23961,373,804,914,1217,541,413,1908,223433,1.3099273607748183,680.6247130394253
2110,289,23961,521,814,890,1282,369,468,1674,172692,0.7884615384615384,595.9739927211589
2111,525,23961,466,761,852,1305,386,544,1860,209984,0.7095588235294118,667.0322331042181
2112,23,23961,203,767,827,1391,624,624,2496,389376,1.0,882.4692629208113
2113,957,23961,399,763,957,1382,558,619,2354,345402,0.9014539579967691,833.3816652650813
2114,1378,23961,458,732,927,1409,469,677,2292,317513,0.6927621861152142,823.5836326688383
2115,648,33743,66,929,208,1128,142,199,682,28258,0.7135678391959799,244.468811916776
2116,759,33743,72,934,189,1140,117,206,646,24102,0.5679611650485437,236.90715480964266
2117,32,33743,104,947,183,1134,79,187,532,14773,0.4224598930481284,203.00246303924493
2118,311,8127,109,713,521,971,412,258,1340,106296,1.5968992248062015,486.11521268110914
2119,866,8127,294,530,596,785,302,255,1114,77010,1.184313725490196,395.2581434961208
2120,448,8127,365,552,562,819,197,267,928,52599,0.7378277153558053,331.8101867031813
2121,375,8127,126,524,641,948,515,424,1878,218360,1.214622641509434,667.0839527375846
2122,154,8127,109,569,583,960,474,391,1730,185334,1.2122762148337596,614.456670563515
2123,1463,8127,33,510,665,987,632,477,2218,301464,1.3249475890985325,791.8036372737877
2124,213,8127,107,517,585,945,478,428,1812,204584,1.116822429906542,641.6135908784976
2125,265,8127,90,708,486,975,396,267,1326,105732,1.4831460674157304,477.60339194775406
2126,1685,8127,128,743,531,985,403,242,1290,97526,1.665289256198347,470.07765315956044
2127,1361,8127,337,520,597,730,260,210,940,54600,1.238095238095238,334.21549934136806
2128,15,25530,125,123,708,744,583,621,2408,362043,0.9388083735909822,851.7804881540784
2129,679,25530,165,155,630,545,465,390,1710,181350,1.1923076923076923,606.8978497243173
2130,941,25530,128,106,763,796,635,690,2650,438150,0.9202898550724636,937.723306738187
2131,1000,25530,208,207,713,693,505,486,1982,245430,1.0390946502057614,700.8716002236073
2132,242,25530,77,113,826,755,749,642,2782,480858,1.1666666666666667,986.491256930339
2133,297,18490,37,518,287,787,250,269,1038,67250,0.929368029739777,367.2342576612373
2134,1728,18490,66,534,291,768,225,234,918,52650,0.9615384615384616,324.6243983436858
2135,1074,18490,51,514,221,730,170,216,772,36720,0.7870370370370371,274.87451682540524
2136,699,18490,80,525,299,746,219,221,880,48399,0.990950226244344,311.1301978272119
2137,367,18490,87,534,291,759,204,225,858,45900,0.9066666666666666,303.71203466441693
2138,766,18490,91,542,288,753,197,211,816,41567,0.9336492890995258,288.6693610343848
2139,1562,21553,63,157,867,627,804,470,2548,377880,1.7106382978723405,931.298018896207
2140,865,21553,60,138,861,624,801,486,2574,389286,1.648148148148148,936.9082132204841
2141,805,21553,29,118,457,501,428,383,1622,163924,1.1174934725848564,574.3457147050024
2142,1508,21553,88,166,364,471,276,305,1162,84180,0.9049180327868852,411.34049156386243
2143,966,21553,36,74,635,514,599,440,2078,263560,1.3613636363636363,743.2368397758551
2144,592,21553,51,91,896,653,845,562,2814,474890,1.50355871886121,1014.82461538928
2145,916,6606,75,246,651,611,576,365,1882,210240,1.578082191780822,681.9098180844737
2146,1216,6606,80,329,701,598,621,269,1780,167049,2.3085501858736057,676.7584502612435
2147,1621,6606,99,349,702,516,603,167,1540,100701,3.6107784431137726,625.6980102253802
2148,1092,6606,83,327,644,533,561,206,1534,115566,2.7233009708737863,597.6261373132872
2149,1459,6606,89,345,589,554,500,209,1418,104500,2.392344497607656,541.923426325159
2150,352,34774,190,363,803,1204,613,841,2908,515533,0.7288941736028538,1040.696881901738
2151,1487,34774,52,231,1019,1231,967,1000,3934,967000,0.9670000000000001,1391.0747643458997
2152,952,34774,187,292,872,1179,685,887,3144,607595,0.7722660653889515,1120.7113812217667
2153,603,30200,128,879,424,1192,296,313,1218,92648,0.9456869009584664,430.7957752810489
2154,538,30200,121,910,426,1178,305,268,1146,81740,1.138059701492537,406.01600953656987
2155,723,30200,102,887,104,888,2,1,6,2,2.0,2.23606797749979
2156,912,30200,150,982,258,1179,108,197,610,21276,0.5482233502538071,224.66196829904254
2157,768,30200,135,949,305,1196,170,247,834,41990,0.6882591093117408,299.84829497597616
2158,602,30200,132,914,420,1157,288,243,1062,69984,1.1851851851851851,376.8195854782498
2159,1741,30200,88,875,456,1174,368,299,1334,110032,1.2307692307692308,474.157146946031
2160,665,30200,73,865,474,1184,401,319,1440,127919,1.2570532915360502,512.4080405302009
2161,161,30200,122,950,312,1194,190,244,868,46360,0.7786885245901639,309.2507073556987
2162,151,30200,135,890,460,1189,325,299,1248,97175,1.0869565217391304,441.61748153803876
2163,1215,30200,95,875,368,1152,273,277,1100,75621,0.9855595667870036,388.91901470614675
2164,781,19080,47,792,684,1234,637,442,2158,281554,1.4411764705882353,775.3276726649192
2165,1473,19080,52,796,769,1322,717,526,2486,377142,1.3631178707224334,889.2496837221815
2166,1223,19080,50,786,874,1346,824,560,2768,461440,1.4714285714285715,996.2810848349977
2167,1061,11372,184,511,295,668,111,157,536,17427,0.7070063694267515,192.27584351654787
2168,625,11372,145,489,317,707,172,218,780,37496,0.7889908256880734,277.68327281274975
2169,637,11372,144,460,356,702,212,242,908,51304,0.8760330578512396,321.72659200010185
2170,126,11372,166,455,315,689,149,234,766,34866,0.6367521367521367,277.41124706831914
2171,1130,11372,94,458,378,696,284,238,1044,67592,1.1932773109243695,370.5401462729781
2172,421,11372,149,477,345,694,196,217,826,42532,0.9032258064516128,292.41238003887594
2173,952,11372,249,481,271,541,22,60,164,1320,0.36666666666666653,63.90618123468183
2174,419,11372,181,508,283,705,102,197,598,20094,0.5177664974619289,221.84003245582164
2175,14,11372,31,433,369,724,338,291,1258,98358,1.1615120274914092,446.0100895719737
2176,1237,11372,171,475,324,651,153,176,658,26928,0.8693181818181818,233.20591759215716
2177,1684,15421,85,297,699,844,614,547,2322,335858,1.1224862888482632,822.3168489092267
2178,549,15421,64,394,650,893,586,499,2170,292414,1.1743486973947896,769.6733073194107
2179,447,15421,155,282,744,767,589,485,2148,285665,1.2144329896907216,762.9849277672528
2180,552,15421,127,292,623,811,496,519,2030,257424,0.9556840077071292,717.8976250134834
2181,1506,4048,57,667,901,1339,844,672,3032,567168,1.255952380952381,1078.8512409039533
2182,1389,4048,54,686,952,1322,898,636,3068,571128,1.4119496855345912,1100.4090148667449
2183,1562,4048,79,669,938,1355,859,686,3090,589274,1.2521865889212829,1099.3075092984675
2184,972,4048,176,707,899,1364,723,657,2760,475011,1.1004566210045663,976.9227195638354
2185,204,3927,19,520,161,709,142,189,662,26838,0.7513227513227513,236.40008460235373
2186,203,3927,47,515,168,671,121,156,554,18876,0.7756410256410257,197.4259354796122
2187,858,3927,29,517,162,705,133,188,642,25004,0.7074468085106383,230.28894893155424
2188,1189,13353,55,270,926,951,871,681,3104,593151,1.2790014684287812,1105.622901354707
2189,338,13353,283,395,719,541,436,146,1164,63656,2.9863013698630136,459.795606764571
2190,334,13353,43,270,904,947,861,677,3076,582897,1.2717872968980797,1095.2853509474141
2191,1052,13353,121,325,853,956,732,631,2726,461892,1.1600633914421552,966.4289937703649
2192,73,13353,78,274,877,951,799,677,2952,540923,1.1802067946824224,1047.2487765569363
2193,630,13353,411,389,781,895,370,506,1752,187220,0.7312252964426877,626.8460736097818
2194,1183,29123,42,500,172,643,130,143,546,18590,0.9090909090909092,193.25889371514057
2195,1011,29123,51,525,162,635,111,110,442,12210,1.009090909090909,156.27219842313605
2196,852,29123,42,527,163,636,121,109,460,13189,1.1100917431192658,162.85576440519384
2197,10,29123,45,521,212,636,167,115,564,19205,1.4521739130434783,202.76587484091104
2198,952,29123,29,529,166,621,137,92,458,12604,1.4891304347826086,165.0242406436097
2199,1272,21223,79,607,302,793,223,186,818,41478,1.1989247311827955,290.38767191463205
2200,2,21223,41,657,233,767,192,110,604,21120,1.7454545454545454,221.27810555949722
2201,1476,21223,89,610,294,781,205,171,752,35055,1.1988304093567252,266.9569253643741
2202,1219,21223,35,611,261,802,226,191,834,43166,1.1832460732984291,295.9003210542361
2203,1702,21223,129,599,276,785,147,186,666,27342,0.7903225806451613,237.0759372015642
2204,678,21223,85,603,297,794,212,191,806,40492,1.1099476439790577,285.3506614676055
2205,0,21223,32,602,294,795,262,193,910,50566,1.3575129533678756,325.41204648875555
2206,938,21223,101,619,263,786,162,167,658,27054,0.9700598802395208,232.66499521844707
2207,712,6665,52,855,76,874,24,19,86,456,1.263157894736842,30.610455730027933
2208,1160,6665,49,858,79,877,30,19,98,570,1.5789473684210529,35.510561809129406
2209,916,6665,45,850,80,877,35,27,124,945,1.2962962962962965,44.204072210600685
2210,1361,6665,62,851,81,872,19,21,80,399,0.9047619047619048,28.319604517012593
2211,158,6665,51,855,74,872,23,17,80,391,1.3529411764705883,28.600699292150182
2212,166,6665,49,850,81,878,32,28,120,896,1.1428571428571428,42.5205832509386
2213,875,6665,48,854,80,873,32,19,102,608,1.6842105263157894,37.21558813185679
2214,266,6665,48,850,77,876,29,26,110,754,1.1153846153846154,38.948684188300895
2215,161,6665,46,851,77,875,31,24,110,744,1.2916666666666667,39.20459156782532
2216,947,5920,145,719,413,898,268,179,894,47972,1.4972067039106145,322.28093334853054
2217,1420,5920,136,714,419,919,283,205,976,58015,1.380487804878049,349.44813635216315
2218,1434,5920,135,711,420,916,285,205,980,58425,1.3902439024390243,351.0697936308392
2219,1268,26858,130,227,814,636,684,409,2186,279756,1.6723716381418092,796.9548293347623
2220,1114,26858,49,195,837,613,788,418,2412,329384,1.8851674641148328,892.0022421496484
2221,567,26858,339,229,830,545,491,316,1614,155156,1.5537974683544304,583.8981075495964
2222,115,26858,23,159,801,669,778,510,2576,396780,1.5254901960784313,930.2601786597124
2223,1643,26858,60,188,816,640,756,452,2416,341712,1.672566371681416,880.8178018182875
2224,1418,26858,19,190,799,604,780,414,2388,322920,1.884057971014493,883.0605868228974
2225,421,9922,70,638,669,1084,599,446,2090,267154,1.34304932735426,746.8045259637893
2226,344,9922,540,791,658,831,118,40,316,4720,2.95,124.59534501738017
2227,187,9922,95,690,784,1144,689,454,2286,312806,1.5176211453744493,825.1284748449783
2228,396,30583,145,573,422,828,277,255,1064,70635,1.0862745098039217,376.5023240300118
2229,1046,30583,156,601,460,789,304,188,984,57152,1.6170212765957446,357.4353088322417
2230,226,30583,185,609,397,788,212,179,782,37948,1.1843575418994414,277.46170906991836
2231,621,30583,141,581,368,804,227,223,900,50621,1.0179372197309418,318.2106220728654
2232,118,30583,162,579,410,815,248,236,968,58528,1.0508474576271187,342.3448553724738
2233,886,30583,150,577,430,826,280,249,1058,69720,1.1244979919678717,374.70121430280955
2234,1594,30583,132,573,436,832,304,259,1126,78736,1.1737451737451738,399.3707550635124
2235,1065,5676,95,941,165,1034,70,93,326,6510,0.7526881720430108,116.40017182117903
2236,149,5676,129,932,174,1033,45,101,292,4545,0.4455445544554456,110.57124400132251
2237,493,5676,102,930,195,1041,93,111,408,10323,0.8378378378378378,144.81022063376605
2238,137,5676,111,917,205,1041,94,124,436,11656,0.7580645161290323,155.60205654167942
2239,1723,5676,186,927,187,928,1,1,4,1,1.0,1.4142135623730951
2240,90,5676,86,938,206,1041,120,103,446,12360,1.1650485436893203,158.14234094637652
2241,809,5676,107,924,210,1042,103,118,442,12154,0.8728813559322034,156.6301375853319
2242,1451,5676,107,933,194,1041,87,108,390,9396,0.8055555555555556,138.68309197591464
2243,969,5676,139,964,155,988,16,24,80,384,0.6666666666666666,28.844410203711913
2244,865,5676,99,933,207,1042,108,109,434,11772,0.9908256880733946,153.44380078712857
2245,967,5676,115,927,181,1036,66,109,350,7194,0.6055045871559633,127.4244874425634
2246,1700,24381,57,310,479,662,422,352,1548,148544,1.1988636363636365,549.5343483350244
2247,1223,24381,37,304,510,676,473,372,1690,175956,1.271505376344086,601.7582571099462
2248,620,24381,62,370,489,626,427,256,1366,109312,1.66796875,497.86042220686716
2249,1610,19239,164,541,911,1152,747,611,2716,456417,1.2225859247135842,965.0544026115833
2250,944,19239,49,453,999,1181,950,728,3356,691600,1.304945054945055,1196.8642362440278
2251,891,19239,23,428,1040,1181,1017,753,3540,765801,1.350597609561753,1265.4240396009552
2252,1185,19239,19,426,1040,1179,1021,753,3548,768813,1.3559096945551128,1268.6410051704934
2253,894,19239,137,488,989,1175,852,687,3078,585324,1.240174672489083,1094.4738461927723
2254,240,19239,351,601,760,1124,409,523,1864,213907,0.7820267686424475,663.9352378056161
2255,809,15763,51,324,820,848,769,524,2586,402956,1.467557251908397,930.5573598655808
2256,651,15763,79,325,728,811,649,486,2270,315414,1.3353909465020577,810.8002220029297
2257,961,15763,305,497,567,640,262,143,810,37466,1.8321678321678316,298.4845054605012
2258,965,15763,72,316,720,802,648,486,2268,314928,1.3333333333333333,810.0
2259,537,15763,340,527,480,581,140,54,388,7560,2.592592592592593,150.05332385522155
2260,656,32366,44,378,320,658,276,280,1112,77280,0.9857142857142858,393.1615444063674
2261,1244,32366,27,369,338,660,311,291,1204,90501,1.0687285223367695,425.9131366839957
2262,1684,32366,54,386,310,619,256,233,978,59648,1.098712446351931,346.1574786134195
2263,375,32366,53,369,321,636,268,267,1070,71556,1.00374531835206,378.3027887816848
2264,766,18493,92,472,309,647,217,175,784,37975,1.24,278.77230852435827
2265,699,18493,37,451,304,655,267,204,942,54468,1.3088235294117647,336.0133925902359
2266,1567,18493,17,387,462,712,445,325,1540,144625,1.3692307692307693,551.0444628158422
2267,1074,18493,51,425,390,671,339,246,1170,83394,1.3780487804878048,418.8520025020771
2268,1370,15374,63,770,195,915,132,145,554,19140,0.9103448275862068,196.08416560242696
2269,387,15374,46,755,208,920,162,165,654,26730,0.9818181818181818,231.23364807051763
2270,1107,15374,41,774,204,924,163,150,626,24450,1.086666666666667,221.51523649627356
2271,809,15150,125,432,489,697,364,265,1258,96460,1.3735849056603773,450.2454885948331
2272,1508,15150,136,466,485,700,349,234,1166,81666,1.4914529914529917,420.18686319303225
2273,1067,15150,108,408,540,702,432,294,1452,127008,1.4693877551020411,522.5514328752721
2274,1562,15150,147,449,434,630,287,181,936,51947,1.5856353591160222,339.3081195609678
2275,1136,15150,142,449,537,685,395,236,1262,93220,1.6737288135593218,460.1315029423654
2276,105,30112,100,419,894,936,794,517,2622,410498,1.5357833655705997,947.4835090913192
2277,1748,30112,96,452,854,932,758,480,2476,363840,1.5791666666666666,897.1978600063645
2278,831,30112,68,419,706,970,638,551,2378,351538,1.1578947368421053,842.9976275174207
2279,1351,32551,54,1477,75,1491,21,14,70,294,1.5,25.238858928247925
2280,656,32551,55,1477,74,1491,19,14,66,266,1.3571428571428572,23.600847442411894
2281,1513,32551,55,1477,75,1491,20,14,68,280,1.4285714285714286,24.413111231467404
2282,465,32182,77,392,242,497,165,105,540,17325,1.5714285714285714,195.57607215607945
2283,952,32182,86,384,217,499,131,115,492,15065,1.1391304347826088,174.3158053648607
2284,1548,32182,78,373,240,534,162,161,646,26082,1.0062111801242235,228.39658491317246
2285,191,32182,62,420,271,487,209,67,552,14003,3.1194029850746268,219.4766502386985
2286,525,32182,95,380,216,505,121,125,492,15125,0.968,173.97126199461795
2287,128,32182,58,368,268,497,210,129,678,27090,1.627906976744186,246.45689278249046
2288,1281,32182,87,369,261,502,174,133,614,23142,1.3082706766917294,219.0091322296858
2289,237,32182,72,381,251,574,179,193,744,34547,0.9274611398963728,263.2299375071156
2290,1709,32182,49,356,245,506,196,150,692,29400,1.3066666666666666,246.81166909204273
2291,105,30121,309,455,416,609,107,154,522,16478,0.6948051948051948,187.52333188166213
2292,602,30121,45,460,424,772,379,312,1382,118248,1.2147435897435896,490.90223059179516
2293,1295,30121,172,462,400,627,228,165,786,37620,1.3818181818181818,281.44093518889537
2294,1741,30121,46,450,417,782,371,332,1406,123172,1.1174698795180722,497.86042220686716
2295,1748,30121,60,458,397,750,337,292,1258,98404,1.154109589041096,445.9069409641433
2296,1585,30121,64,548,179,712,115,164,558,18860,0.7012195121951219,200.30227157973022
2297,831,30121,78,460,424,690,346,230,1152,79580,1.5043478260869565,415.47081726638754
2298,161,30121,36,516,209,777,173,261,868,45153,0.6628352490421456,313.12936623702353
2299,212,30121,70,559,173,763,103,204,614,21012,0.5049019607843137,228.52789764052878
2300,592,22330,46,831,59,845,13,14,54,182,0.9285714285714286,19.1049731745428
2301,693,22330,46,831,60,845,14,14,56,196,1.0,19.79898987322333
2302,93,22330,47,832,58,845,11,13,48,143,0.8461538461538461,17.029386365926403
2303,1435,4846,87,717,382,953,295,236,1062,69620,1.25,377.78433000853806
2304,1438,4846,58,706,385,904,327,198,1050,64746,1.6515151515151516,382.27346232769025
2305,1229,4846,52,708,388,955,336,247,1166,82992,1.360323886639676,417.0191842109905
2306,66,9813,62,967,219,1098,157,131,576,20567,1.1984732824427482,204.47493733951845
2307,886,9813,59,972,223,1098,164,126,580,20664,1.3015873015873016,206.81392603013947
2308,458,9813,91,974,225,1089,134,115,498,15410,1.1652173913043478,176.58142597679972
2309,60,26303,43,294,650,920,607,626,2466,379982,0.9696485623003196,871.9661690685024
2310,1532,26303,54,291,637,982,583,691,2548,402853,0.8437047756874095,904.085172978741
2311,1218,26303,57,313,640,1001,583,688,2542,401104,0.8473837209302325,901.7943224483064
2312,1264,26303,6,272,676,1077,670,805,2950,539350,0.8322981366459627,1047.3418735064497
2313,507,26303,52,362,677,927,625,565,2380,353125,1.106194690265487,842.525963991615
2314,1046,26303,185,514,530,879,345,365,1420,125925,0.9452054794520548,502.24496015390736
2315,671,26303,77,303,83,310,6,7,26,42,0.8571428571428571,9.219544457292887
2316,1472,26303,70,359,668,995,598,636,2468,380328,0.940251572327044,872.9833904490966
2317,788,26303,70,322,662,1023,592,701,2586,414992,0.8445078459343794,917.5320157901848
2318,1470,26303,73,323,671,1014,598,691,2578,413218,0.8654124457308249,913.8298528719665
2319,886,26303,38,281,641,1054,603,773,2752,466119,0.7800776196636481,980.3764583056858
2320,1368,26303,77,514,536,762,459,248,1414,113832,1.8508064516129032,521.7135229223027
2321,1411,26303,21,286,666,1073,645,787,2864,507615,0.8195679796696315,1017.5431194794646
2322,1186,34994,122,851,556,1254,434,403,1674,174902,1.0769230769230769,592.2541684108268
2323,525,34994,217,869,469,1248,252,379,1262,95508,0.6649076517150396,455.1318490283887
2324,191,34994,158,857,464,1176,306,319,1250,97614,0.9592476489028212,442.0373287404583
2325,748,14350,113,563,220,708,107,145,504,15515,0.7379310344827587,180.20543831971332
2326,1177,14350,39,531,119,628,80,97,354,7760,0.8247422680412371,125.73384588089239
2327,336,14350,46,519,301,765,255,246,1002,62730,1.0365853658536586,354.31765409022455
2328,1233,14350,36,520,294,748,258,228,972,58824,1.131578947368421,344.30800164968576
2329,1710,14350,47,499,259,784,212,285,994,60420,0.7438596491228069,355.2027589982938
2330,1048,14350,41,513,284,740,243,227,940,55161,1.0704845814977977,332.53270515845503
2331,802,14350,129,562,258,703,129,141,540,18189,0.9148936170212766,191.10729970359583
2332,947,14350,42,533,111,647,69,114,366,7866,0.6052631578947368,133.25539388707685
2333,255,10626,127,622,629,893,502,271,1546,136042,1.85239852398524,570.4778698599973
2334,1239,10626,166,632,585,866,419,234,1306,98046,1.790598290598291,479.9135338787603
2335,140,10626,125,579,712,906,587,327,1828,191949,1.7951070336391437,671.9360088579864
2336,1663,10626,119,652,619,871,500,219,1438,109500,2.2831050228310503,545.8580401532985
2337,305,10626,200,603,205,606,5,3,16,15,1.6666666666666667,5.830951894845301
2338,805,10626,68,614,606,883,538,269,1614,144722,2.0,601.5022859474434
2339,1585,28398,42,706,321,850,279,144,846,40176,1.9375,313.9697437652233
2340,822,28398,69,711,291,880,222,169,782,37518,1.3136094674556211,279.00716836669267
2341,1257,28398,47,708,318,883,271,175,892,47425,1.5485714285714285,322.5926223582926
2342,735,27993,391,609,577,797,186,188,748,34968,0.9893617021276596,264.4617174564213
2343,1411,27993,208,503,601,844,393,341,1468,134013,1.152492668621701,520.3172109396344
2344,172,27993,374,555,595,840,221,285,1012,62985,0.775438596491228,360.64664146502184
2345,886,27993,384,588,592,797,208,209,834,43472,0.9952153110047848,294.8643756034289
2346,66,27993,393,584,588,803,195,219,828,42705,0.8904109589041096,293.23369519889764
2347,282,27993,393,596,578,829,185,233,836,43105,0.7939914163090128,297.51302492496023
2348,141,32,42,799,128,881,86,82,336,7052,1.0487804878048779,118.82760622010359
2349,366,32,39,809,128,884,89,75,328,6675,1.1866666666666668,116.3872845288522
2350,903,32,41,809,126,883,85,74,318,6290,1.148648648648649,112.69871339105873
2351,1224,17990,75,779,502,1118,427,339,1532,144753,1.2595870206489677,545.2063829413592
2352,1045,17990,42,783,505,1145,463,362,1650,167606,1.2790055248618784,587.7184700177459
2353,109,17990,99,773,574,1178,475,405,1760,192375,1.1728395061728396,624.2195126716242
2354,1473,17990,59,778,574,1170,515,392,1814,201880,1.3137755102040816,647.216347135948
2355,116,17990,54,765,571,1172,517,407,1848,210419,1.2702702702702702,657.9802428644799
2356,369,16809,99,1015,432,1274,333,259,1184,86247,1.2857142857142858,421.86490728668105
2357,538,16809,53,1007,479,1359,426,352,1556,149952,1.2102272727272727,552.6119796023246
2358,264,16809,48,984,486,1414,438,430,1736,188340,1.0186046511627906,613.7947539691098
2359,862,190,62,749,648,1437,586,688,2548,403168,0.8517441860465116,903.7366873155034
2360,252,190,162,758,608,1517,446,759,2410,338514,0.5876152832674572,880.3391391957988
2361,700,190,128,817,666,1497,538,680,2436,365840,0.7911764705882353,867.0893840890915
2362,1662,190,55,740,642,1456,587,716,2606,420292,0.8198324022346368,925.8644609228718
2363,436,190,52,771,685,1487,633,716,2698,453228,0.8840782122905028,955.6908495952025
2364,1435,20303,110,228,650,825,540,597,2274,322380,0.9045226130653268,804.9900620504578
2365,337,20303,79,243,620,836,541,593,2268,320813,0.9123102866779088,802.7016880510467
2366,523,20303,90,136,625,811,535,675,2420,361125,0.7925925925925926,861.307146144742
2367,1182,20303,276,272,667,706,391,434,1650,169694,0.9009216589861752,584.1549451986176
2368,71,20303,158,173,655,742,497,569,2132,282793,0.8734622144112478,755.4932163825166
2369,848,20303,290,222,689,516,399,294,1386,117306,1.3571428571428572,495.6177962906498
2370,852,20303,101,208,639,816,538,608,2292,327104,0.8848684210526315,811.8546667969582
2371,843,20303,130,184,635,632,505,448,1906,226240,1.1272321428571428,675.0770326414608
2372,30,20303,339,206,614,551,275,345,1240,94875,0.7971014492753623,441.1915683691156
2373,413,16538,57,1037,71,1051,14,14,56,196,1.0,19.79898987322333
2374,477,16538,56,1038,70,1051,14,13,54,182,1.0769230769230769,19.1049731745428
2375,193,16538,55,1036,71,1052,16,16,64,256,1.0,22.627416997969522
2376,636,23135,70,460,416,709,346,249,1190,86154,1.3895582329317269,426.28277000132204
2377,68,23135,80,461,361,693,281,232,1026,65192,1.2112068965517242,364.3967617858315
2378,682,23135,82,468,397,679,315,211,1052,66465,1.4928909952606635,379.1384971220939
2379,576,23135,42,454,422,705,380,251,1262,95380,1.5139442231075697,455.4129993752923
2380,1549,23135,94,456,380,704,286,248,1068,70928,1.153225806451613,378.549864614954
2381,752,23135,36,453,414,715,378,262,1280,99036,1.4427480916030535,459.92173247195007
2382,27,23135,93,462,332,673,239,211,900,50429,1.132701421800948,318.8134250623709
2383,472,23135,76,470,402,659,326,189,1030,61614,1.7248677248677249,376.8248930206177
2384,15,23135,42,459,419,708,377,249,1252,93873,1.5140562248995983,451.8074811244276
2385,952,23135,149,473,324,711,175,238,826,41650,0.7352941176470589,295.4132698441287
2386,525,23135,104,489,307,672,203,183,772,37149,1.1092896174863387,273.3093485411723
2387,228,3382,83,967,350,1166,267,199,932,53133,1.3417085427135678,333.0015014981164
2388,618,3382,70,1009,402,1187,332,178,1020,59096,1.8651685393258424,376.70678252455184
2389,1263,3382,83,935,363,1182,280,247,1054,69160,1.1336032388663968,373.3751464679994
2390,1668,12564,33,605,691,1244,658,639,2594,420462,1.029733959311424,917.2158960680958
2391,1672,12564,22,592,907,1246,885,654,3078,578790,1.3532110091743121,1100.4276441456748
2392,909,12564,94,605,750,1238,656,633,2578,415248,1.0363349131121642,911.6057261777155
2393,650,12564,27,588,915,1249,888,661,3098,586968,1.3434190620272315,1107.0072267153453
2394,1389,12564,22,594,907,1246,885,652,3074,577020,1.3573619631901839,1099.2401921327294
2395,1352,2685,44,871,397,1132,353,261,1228,92133,1.3524904214559388,439.0102504498044
2396,268,2685,43,895,237,1036,194,141,670,27354,1.375886524822695,239.82702099638396
2397,96,2685,64,878,382,1115,318,237,1110,75366,1.3417721518987342,396.60181542700985
2398,164,2685,192,936,394,1127,202,191,786,38582,1.057591623036649,278.0017985553331
2399,550,2685,49,876,394,1133,345,257,1204,88665,1.3424124513618676,430.20227800419656
2400,1028,2685,210,1014,267,1065,57,51,216,2907,1.1176470588235294,76.48529270389177
2401,655,2685,82,881,373,1131,291,250,1082,72750,1.1640000000000001,383.64175997928066
2402,105,2685,70,880,385,1129,315,249,1128,78435,1.2650602409638554,401.529575498493
2403,612,28739,80,998,929,1372,849,374,2446,317526,2.270053475935829,927.7267916795332
2404,61,28739,104,964,900,1330,796,366,2324,291336,2.1748633879781423,876.1118650035507
2405,619,28739,121,952,926,1407,805,455,2520,366275,1.7692307692307692,924.6891369536035
2406,291,8316,136,792,336,956,200,164,728,32800,1.2195121951219512,258.6426105652354
2407,421,8316,101,798,230,956,129,158,574,20382,0.8164556962025317,203.9730374338726
2408,899,8316,47,794,224,957,177,163,680,28851,1.0858895705521472,240.6200324162558
2409,74,8316,71,799,358,926,287,127,828,36449,2.25984251968504,313.84391024839084
2410,124,8316,38,784,249,954,211,170,762,35870,1.241176470588235,270.96309711840837
2411,25,8316,127,815,191,870,64,55,238,3520,1.1636363636363636,84.38601779915912
2412,343,8316,69,792,224,945,155,153,616,23715,1.0130718954248366,217.79348015953096
2413,753,8316,43,752,284,959,241,207,896,49887,1.1642512077294689,317.6948221170751
2414,635,8316,69,818,215,937,146,119,530,17374,1.2268907563025209,188.35339126227592
2415,76,8316,78,798,234,941,156,143,598,22308,1.0909090909090908,211.62466774929618
2416,32,34247,50,1322,218,1416,168,94,524,15792,1.7872340425531914,192.50974001333023
2417,94,34247,50,1319,218,1433,168,114,564,19152,1.4736842105263157,203.02709178826356
2418,250,34247,50,1311,147,1423,97,112,418,10864,0.8660714285714286,148.16544806398016
2419,765,34247,53,1321,137,1408,84,87,342,7308,0.9655172413793104,120.93386622447825
2420,138,34247,63,1338,134,1405,71,67,276,4757,1.0597014925373134,97.62171889492625
2421,88,34247,50,1329,205,1414,155,85,480,13175,1.8235294117647056,176.7766952966369
2422,814,34247,56,1323,197,1413,141,90,462,12690,1.5666666666666669,167.2752223134078
2423,1092,5778,292,796,694,1191,402,395,1594,158790,1.017721518987342,563.5858408441433
2424,1097,5778,242,809,679,1195,437,386,1646,168682,1.1321243523316062,583.0651764597162
2425,1399,5778,333,860,589,1114,256,254,1020,65024,1.0078740157480317,360.6272313622475
2426,830,5778,284,838,496,1041,212,203,830,43036,1.0443349753694582,293.51831288694746
2427,1459,5778,310,825,652,1161,342,336,1356,114912,1.0178571428571428,479.4371700233514
2428,1353,5778,301,830,681,1200,380,370,1500,140600,1.027027027027027,530.3772242470448
2429,1694,5778,288,830,585,1206,297,376,1346,111672,0.7898936170212766,479.15028957520207
2430,1164,5778,304,856,615,1139,311,283,1188,88013,1.0989399293286222,420.4878119517854
2431,916,5778,306,816,643,1160,337,344,1362,115928,0.9796511627906976,481.56515654685813
2432,57,21098,234,660,660,1296,426,636,2124,270936,0.6698113207547169,765.4880795936668
2433,1158,21098,60,544,880,1424,820,880,3400,721600,0.9318181818181818,1202.8299963003915
2434,553,21098,57,550,907,1400,850,850,3400,722500,1.0,1202.0815280171307
2435,1689,21098,87,764,756,1360,669,596,2530,398724,1.12248322147651,895.9782363428254
2436,651,15722,26,343,180,400,154,57,422,8778,2.701754385964912,164.21023110634732
2437,537,15722,76,376,115,387,39,11,100,429,3.5454545454545454,40.52159917870962
2438,965,15722,42,351,194,413,152,62,428,9424,2.4516129032258065,164.1584600317632
2439,1347,15722,28,341,185,420,157,79,472,12403,1.9873417721518989,175.75551200460256
2440,961,15722,17,322,202,434,185,112,594,20720,1.6517857142857142,216.26141588364763
2441,809,15722,32,335,202,438,170,103,546,17510,1.6504854368932038,198.76870981117727
2442,400,26393,192,500,543,682,351,182,1066,63882,1.9285714285714288,395.37956446938426
2443,567,26393,202,498,533,678,331,180,1022,59580,1.8388888888888888,376.77712244774096
2444,1418,26393,154,502,549,716,395,214,1218,84530,1.8457943925233644,449.24492206367785
2445,1698,26393,184,486,381,641,197,155,704,30535,1.2709677419354841,250.6671099286861
2446,115,26393,184,474,547,697,363,223,1172,80949,1.6278026905829597,426.0258208137155
2447,1323,26393,173,486,551,733,378,247,1250,93366,1.5303643724696356,451.5451250982564
2448,1311,26393,152,494,402,670,250,176,852,44000,1.4204545454545454,305.73845031333565
2449,181,26393,199,527,546,699,347,172,1038,59684,2.0174418604651163,387.28929755416686
2450,1116,26393,193,490,421,670,228,180,816,41040,1.2666666666666666,290.4892424858449
2451,886,26393,188,498,369,635,181,137,636,24797,1.3211678832116789,227.00220263248548
2452,1707,26393,204,518,368,638,164,120,568,19680,1.3666666666666667,203.2141727340886
2453,119,26393,204,521,366,622,162,101,526,16362,1.603960396039604,190.90573590125572
2454,1268,26393,204,461,365,658,161,197,716,31717,0.8172588832487309,254.42091109026396
2455,878,26393,215,498,550,669,335,171,1012,57285,1.9590643274853798,376.11966180990856
2456,1605,26393,163,505,383,643,220,138,716,30360,1.5942028985507246,259.6998267230843
2457,1118,26393,218,478,359,670,141,192,666,27072,0.734375,238.2120903732638
2458,1703,26393,231,514,504,675,273,161,868,43953,1.6956521739130437,316.9384798348096
2459,1643,26393,161,490,544,697,383,207,1180,79281,1.85024154589372,435.35962146253297
2460,761,26191,85,301,202,465,117,164,562,19188,0.7134146341463414,201.45719148245863
2461,1401,26191,114,340,213,464,99,124,446,12276,0.7983870967741935,158.67261893597143
2462,1030,26191,350,367,501,443,151,76,454,11476,1.9868421052631582,169.04733065032408
2463,1361,26191,62,288,246,513,184,225,818,41400,0.8177777777777778,290.65615424415154
2464,379,26191,74,343,172,541,98,198,592,19404,0.494949494949495,220.92532675091826
2465,656,26191,67,335,219,580,152,245,794,37240,0.6204081632653061,288.3210016630769
2466,1307,26191,53,318,217,561,164,243,814,39852,0.6748971193415638,293.1637767528587
2467,1085,26191,40,296,204,597,164,301,930,49364,0.5448504983388704,342.7783540423753
2468,1573,26191,111,297,186,404,75,107,364,8025,0.7009345794392523,130.66751700403586
2469,1680,26191,47,283,105,324,58,41,198,2378,1.4146341463414631,71.02816342831905
2470,1154,26191,56,308,523,531,467,223,1380,104141,2.094170403587444,517.5113525324831
2471,422,26191,66,296,202,590,136,294,860,39984,0.4625850340136055,323.9320916488516
2472,1145,29008,198,400,736,868,538,468,2012,251784,1.1495726495726497,713.069421585304
2473,252,29008,334,574,524,861,190,287,954,54530,0.662020905923345,344.19325966671687
2474,1504,29008,375,549,537,692,162,143,610,23166,1.132867132867133,216.08563117431015
2475,589,29008,174,386,731,881,557,495,2104,275715,1.1252525252525252,745.167095355129
2476,1138,29008,211,406,743,881,532,475,2014,252700,1.12,713.1963264066915
2477,907,29008,143,421,674,818,531,397,1856,210807,1.3375314861460956,663.0007541473841
2478,1141,29008,208,405,647,881,439,476,1830,208964,0.9222689075630252,647.5314664168839
2479,485,29008,164,374,710,901,546,527,2146,287742,1.0360531309297911,758.8445163536467
2480,806,29008,236,403,699,851,463,448,1822,207424,1.0334821428571428,644.2615928332217
2481,1348,29008,295,411,591,820,296,409,1410,121064,0.7237163814180929,504.8732514205917
2482,1318,27958,169,363,445,604,276,241,1034,66516,1.1452282157676348,366.4109714514564
2483,735,27958,133,400,497,637,364,237,1202,86268,1.5358649789029537,434.35584490138956
2484,269,27958,164,370,403,557,239,187,852,44693,1.2780748663101604,303.4633421024688
2485,1038,27958,85,347,467,664,382,317,1398,121094,1.2050473186119874,496.400040290087
2486,1411,27958,19,343,502,703,483,360,1686,173880,1.3416666666666666,602.4026892370252
2487,1597,27958,72,364,488,641,416,277,1386,115232,1.5018050541516246,499.78495375511255
2488,172,27958,37,350,456,679,419,329,1496,137851,1.2735562310030395,532.7307011990205
2489,784,27958,233,416,375,500,142,84,452,11928,1.6904761904761905,164.98484778912274
2490,886,27958,87,349,500,652,413,303,1432,125139,1.363036303630363,512.2284646522487
2491,66,27958,71,363,497,628,426,265,1382,112890,1.6075471698113208,501.6981164006897
2492,1113,27958,181,413,419,611,238,198,872,47124,1.2020202020202022,309.5932815808508
2493,850,20383,455,556,746,874,291,318,1218,92538,0.9150943396226416,431.0510410612646
2494,1652,20383,38,432,749,854,711,422,2266,300042,1.6848341232227488,826.804088040208
2495,1721,20383,327,514,715,820,388,306,1388,118728,1.2679738562091505,494.1457274934187
2496,898,20383,23,418,747,867,724,449,2346,325076,1.6124721603563474,851.925466223425
2497,120,20383,501,544,729,863,228,319,1094,72732,0.7147335423197492,392.10330271498606
2498,1329,20383,61,402,744,857,683,455,2276,310765,1.5010989010989007,820.6789871807368
2499,1615,20383,556,493,563,496,7,3,20,21,2.333333333333333,7.615773105863909
2500,125,20383,478,540,745,820,267,280,1094,74760,0.9535714285714286,386.8966270207069
2501,917,13504,142,788,635,1297,493,509,2004,250937,0.9685658153241652,708.6113180016249
2502,831,13504,99,785,657,1226,558,441,1998,246078,1.2653061224489797,711.2278116046925
2503,1212,13504,81,765,627,1262,546,497,2086,271362,1.0985915492957747,738.3258088405146
2504,1241,14020,57,1001,200,1083,143,82,450,11726,1.7439024390243902,164.84234892769516
2505,1439,14020,53,972,212,1077,159,105,528,16695,1.5142857142857142,190.541334098405
2506,1207,14020,73,994,199,1080,126,86,424,10836,1.4651162790697674,152.55163060419906
2507,1733,14020,64,979,202,1081,138,102,480,14076,1.3529411764705883,171.6041957529011
2508,903,14020,58,973,197,1063,139,90,458,12510,1.5444444444444445,165.59287424282482
2509,700,14020,72,979,179,1089,107,110,434,11770,0.9727272727272728,153.45683432157722
2510,909,14020,151,975,179,998,28,23,102,644,1.2173913043478262,36.235341863986875
2511,1383,14020,55,984,194,1080,139,96,470,13344,1.4479166666666667,168.92897915988246
2512,1508,14020,62,1008,133,1074,71,66,274,4686,1.0757575757575757,96.93812459502195
2513,1389,14020,148,972,182,1013,34,41,150,1394,0.8292682926829268,53.2634959423431
2514,174,20968,274,536,814,982,540,446,1972,240840,1.210762331838565,700.3684744475582
2515,1702,20968,268,565,677,920,409,355,1528,145195,1.152112676056338,541.5773259655541
2516,1636,20968,212,570,590,924,378,354,1464,133812,1.0677966101694916,517.880295048962
2517,168,20968,286,573,627,970,341,397,1476,135377,0.8589420654911839,523.345010485435
2518,886,20968,301,602,593,1000,292,398,1380,116216,0.7336683417085427,493.62738983974543
2519,597,11184,189,518,322,655,133,137,540,18221,0.9708029197080292,190.93978108293726
2520,831,11184,181,505,363,667,182,162,688,29484,1.1234567901234571,243.6554944999189
2521,1212,11184,181,507,329,672,148,165,626,24420,0.8969696969696971,221.65062598603234
2522,820,11184,189,517,308,647,119,130,498,15470,0.9153846153846154,176.24131184259835
2523,917,11184,190,528,319,636,129,108,474,13932,1.1944444444444444,168.24089871371942
2524,1405,11184,190,532,317,649,127,117,488,14859,1.0854700854700854,172.67889274604468
2525,1032,11184,190,529,321,661,131,132,526,17292,0.9924242424242424,185.9704277566732
2526,1256,11184,195,529,270,655,75,126,402,9450,0.5952380952380952,146.63219291819925
2527,1646,7290,93,562,642,921,549,359,1816,197091,1.5292479108635098,655.9588401721559
2528,1126,7290,92,610,416,937,324,327,1302,105948,0.9908256880733946,460.3314023613857
2529,742,7290,133,615,590,897,457,282,1478,128874,1.6205673758865249,537.0037243818706
2530,75,7290,126,554,669,923,543,369,1824,200367,1.4715447154471544,656.5135185203729
2531,952,7290,235,667,286,709,51,42,186,2142,1.2142857142857142,66.06814663663572
2532,1133,7290,119,608,517,897,398,289,1374,115022,1.3771626297577857,491.85871955267805
2533,1420,7290,121,598,621,913,500,315,1630,157500,1.5873015873015872,590.9526207742884
2534,947,7290,145,553,646,905,501,352,1706,176352,1.4232954545454546,612.2948636073962
2535,25,7290,100,564,667,916,567,352,1838,199584,1.6107954545454546,667.3777041526035
2536,185,7290,139,644,303,864,164,220,768,36080,0.7454545454545455,274.40116617827994
2537,1427,7290,97,598,614,943,517,345,1724,178365,1.4985507246376812,621.5416317512448
2538,413,15600,40,560,114,616,74,56,260,4144,1.3214285714285714,92.80086206496145
2539,410,15600,45,526,168,639,123,113,472,13899,1.0884955752212389,167.0269439342048
2540,193,15600,38,524,192,632,154,108,524,16632,1.4259259259259258,188.09572031282372
2541,746,15600,50,575,100,600,50,25,150,1250,2.0,55.90169943749474
2542,477,15600,43,536,135,632,92,96,376,8832,0.9583333333333334,132.9661611087573
2543,1435,15600,60,523,139,642,79,119,396,9401,0.6638655462184874,142.8355697996826
2544,105,28987,178,638,794,1151,616,513,2258,316008,1.2007797270955165,801.6389461596785
2545,915,28987,792,1176,796,1180,4,4,16,16,1.0,5.656854249492381
2546,1257,28987,103,659,798,1103,695,444,2278,308580,1.5653153153153154,824.7187399350157
2547,719,28987,535,975,538,978,3,3,12,9,1.0,4.242640687119285
2548,831,28987,266,648,773,1102,507,454,1922,230178,1.1167400881057268,680.5622675405976
2549,1295,28987,142,627,815,1139,673,512,2370,344576,1.314453125,845.619890967567
2550,1585,28987,232,657,757,1108,525,451,1952,236775,1.164079822616408,692.1170421251019
2551,661,4629,55,522,334,738,279,216,990,60264,1.2916666666666667,352.8413241104279
2552,1404,4629,67,530,345,766,278,236,1028,65608,1.1779661016949152,364.66422912043345
2553,100,4629,59,527,367,764,308,237,1090,72996,1.29957805907173,388.6296437483893
2554,952,25072,97,525,694,769,597,244,1682,145668,2.44672131147541,644.9379815145019
2555,1123,25072,23,416,731,968,708,552,2520,390816,1.2826086956521738,897.7572054848682
2556,1053,25072,90,471,396,901,306,430,1472,131580,0.7116279069767442,527.7650992629202
2557,687,25072,55,449,385,882,330,433,1526,142890,0.7621247113163973,544.4162010814888
2558,186,25072,89,414,759,955,670,541,2422,362470,1.2384473197781884,861.1509739877207
2559,957,25072,37,420,377,935,340,515,1710,175100,0.6601941747572816,617.1102008555685
2561,246,18167,42,498,187,609,145,111,512,16095,1.3063063063063065,182.60887163552596
2562,480,18167,42,496,184,601,142,105,494,14910,1.3523809523809525,176.60407696313243
2563,1147,18167,54,496,169,587,115,91,412,10465,1.2637362637362637,146.64924138910504
2564,254,18167,41,497,187,608,146,111,514,16206,1.3153153153153154,183.40392580312997
2565,1537,12371,106,1030,777,1296,671,266,1874,178486,2.522556390977444,721.8012191732569
2566,1002,12371,167,939,508,1179,341,240,1162,81840,1.4208333333333334,416.9904075635314
2567,637,12371,193,1150,529,1422,336,272,1216,91392,1.2352941176470589,432.2961947554015
2568,1282,12371,205,1078,715,1362,510,284,1588,144840,1.795774647887324,583.7430941775672
2569,952,12371,229,1201,369,1281,140,80,440,11200,1.75,161.24515496597098
2570,1003,12371,155,946,780,1390,625,444,2138,277500,1.4076576576576576,766.6557245595966
2571,804,12371,66,958,801,1384,735,426,2322,313110,1.7253521126760565,849.529869986924
2572,1435,4878,58,762,541,1196,483,434,1834,209622,1.1129032258064515,649.3419746173814
2573,1049,4878,55,707,586,1189,531,482,2026,255942,1.1016597510373445,717.1366675885427
2574,684,4878,44,672,570,1190,526,518,2088,272468,1.0154440154440154,738.24115301167
2575,1668,13007,48,858,101,916,53,58,222,3074,0.913793103448276,78.56844150166147
2576,433,13007,54,859,92,910,38,51,178,1938,0.7450980392156863,63.60031446463138
2577,909,13007,56,859,95,921,39,62,202,2418,0.6290322580645161,73.24616030891995
2578,503,17191,62,1063,355,1222,293,159,904,46587,1.8427672955974843,333.36166546260233
2579,672,17191,164,1067,303,1215,139,148,574,20572,0.9391891891891893,203.03940504246953
2580,1642,17191,65,1045,358,1193,293,148,882,43364,1.9797297297297296,328.25752085824325
2581,1322,17191,247,1077,360,1185,113,108,442,12204,1.0462962962962965,156.31058825300352
2582,1416,17191,89,1068,357,1194,268,126,788,33768,2.126984126984127,296.1418578992169
2583,886,10845,36,556,109,614,73,58,262,4234,1.2586206896551724,93.23625904121208
2584,1599,10845,38,559,107,605,69,46,230,3174,1.5,82.92767933567175
2585,1326,10845,33,556,109,613,76,57,266,4332,1.3333333333333333,95.0
2586,1442,7761,22,453,46,476,24,23,94,552,1.0434782608695652,33.24154027718932
2587,1508,7761,22,452,31,475,9,23,64,207,0.39130434782608703,24.698178070456937
2588,1389,7761,23,452,42,476,19,24,86,456,0.7916666666666666,30.610455730027933
2589,687,25094,132,639,317,815,185,176,722,32560,1.0511363636363635,255.34486483969087
2590,1053,25094,112,653,315,808,203,155,716,31465,1.3096774193548386,255.4094751570505
2591,957,25094,101,629,359,843,258,214,944,55212,1.2056074766355143,335.2014319778482
2592,1193,31292,65,210,734,516,669,306,1950,204714,2.1862745098039214,735.6609273299758
2593,1139,31292,102,213,354,479,252,266,1036,67032,0.9473684210526316,366.41506519246724
2594,1508,31292,335,163,762,501,427,338,1530,144326,1.2633136094674555,544.5851632205931
2595,1142,31292,172,256,390,385,218,129,694,28122,1.689922480620155,253.3081127796739
2596,134,31292,92,213,758,598,666,385,2102,256410,1.7298701298701298,769.2730334543127
2597,903,31292,321,170,520,327,199,157,712,31243,1.2675159235668791,253.4758371127315
2598,753,8296,104,563,577,1143,473,580,2106,274340,0.8155172413793104,748.4176641421553
2599,341,8296,168,606,529,1110,361,504,1730,181944,0.7162698412698413,619.9491914665266
2600,343,8296,86,548,567,1097,481,549,2060,264069,0.8761384335154827,729.9054733319925
2601,899,8296,118,574,569,1094,451,520,1942,234520,0.8673076923076923,688.3320419681188
2602,1661,8296,139,606,482,1113,343,507,1700,173901,0.6765285996055227,612.1258040631844
2603,25,8296,419,614,562,879,143,265,816,37895,0.539622641509434,301.1212380420883
2604,875,7617,67,788,193,905,126,117,486,14742,1.0769230769230769,171.9447585708852
2605,161,7617,71,778,177,908,106,130,472,13780,0.8153846153846154,167.73789077009405
2606,1741,7617,57,779,193,909,136,130,532,17680,1.0461538461538462,188.13824704190267
2607,166,7617,56,781,199,896,143,115,516,16445,1.2434782608695651,183.50476833041697
2609,1628,7617,76,783,186,906,110,123,466,13530,0.8943089430894309,165.01212076693034
2610,158,7617,90,796,168,906,78,110,376,8580,0.7090909090909091,134.84806264830058
2611,876,7617,147,790,194,909,47,119,332,5593,0.3949579831932773,127.94530081249565
2612,1160,7617,55,798,143,908,88,110,396,9680,0.8,140.86873322352267
2613,1456,7617,98,804,177,896,79,92,342,7268,0.8586956521739131,121.26417442921878
2614,1400,7617,93,812,196,876,103,64,334,6592,1.609375,121.26417442921878
2615,1284,30204,44,1037,193,1241,149,204,706,30396,0.7303921568627451,252.62026838715852
2616,145,30204,57,1059,179,1203,122,144,532,17568,0.8472222222222222,188.73261509341728
2617,491,30204,51,1044,192,1236,141,192,666,27072,0.734375,238.2120903732638
2618,590,30204,135,1186,136,1188,1,2,6,2,0.5,2.23606797749979
2619,147,30204,48,1037,187,1239,139,202,682,28078,0.6881188118811881,245.20399670478457
2620,1453,30204,47,1032,184,1240,137,208,690,28496,0.6586538461538461,249.06424873915566
2621,1441,30204,41,1034,181,1242,140,208,696,29120,0.6730769230769231,250.7269431074371
2622,483,30204,48,1036,187,1240,139,204,686,28356,0.6813725490196079,246.85420798519922
2623,1508,30204,41,1036,193,1241,152,205,714,31160,0.7414634146341463,255.2038400965001
2624,1698,7535,173,341,640,855,467,514,1962,240038,0.9085603112840468,694.4674218420904
2625,502,7535,39,333,651,763,612,430,2084,263160,1.4232558139534883,747.959891972825
2626,66,7535,207,335,639,876,432,541,1946,233712,0.7985212569316081,692.3185682906388
2627,1181,8924,135,745,419,851,284,106,780,30104,2.679245283018868,303.13693275481955
2628,287,8924,151,749,425,829,274,80,708,21920,3.425,285.4400112107621
2629,29,8924,118,730,270,855,152,125,554,19000,1.216,196.7968495682794
2630,71,8924,142,742,408,865,266,123,778,32718,2.16260162601626,293.0614270080592
2631,748,8924,156,755,437,855,281,100,762,28100,2.81,298.2633064927699
2632,183,8924,150,703,447,879,297,176,946,52272,1.6875,345.23180618245476
2633,525,8924,154,728,487,870,333,142,950,47286,2.3450704225352115,362.01243072579706
2634,25,8924,182,770,245,797,63,27,180,1701,2.333333333333333,68.54195795277518
2635,783,9407,76,951,108,980,32,29,122,928,1.1034482758620692,43.18564576337837
2636,886,9407,52,947,101,992,49,45,188,2205,1.0888888888888888,66.52818951391959
2637,386,9407,77,959,100,976,23,17,80,391,1.3529411764705883,28.600699292150182
2638,1219,9407,54,949,104,991,50,42,184,2100,1.1904761904761905,65.29931086925804
2639,790,9407,52,950,105,992,53,42,190,2226,1.261904761904762,67.62396025078685
2640,1319,9407,55,947,109,990,54,43,194,2322,1.255813953488372,69.02897942168927
2641,1446,31018,81,572,102,610,21,38,118,798,0.5526315789473685,43.41658669218482
2642,1573,31018,72,559,113,616,41,57,196,2337,0.7192982456140351,70.21395872616783
2643,859,31018,76,567,123,628,47,61,216,2867,0.7704918032786885,77.00649323271382
2644,1204,31018,74,563,118,617,44,54,196,2376,0.8148148148148148,69.65629906907199
2645,1671,31018,68,572,115,613,47,41,176,1927,1.146341463414634,62.369864518050704
2646,1664,31018,80,572,103,608,23,36,118,828,0.6388888888888888,42.720018726587654
2647,1706,30934,119,701,567,1106,448,405,1706,181440,1.1061728395061727,603.9279758381789
2648,457,30934,98,713,593,1111,495,398,1786,197010,1.243718592964824,635.1606096098844
2649,391,30934,192,727,593,1088,401,361,1524,144761,1.110803324099723,539.557225880629
2650,387,14575,51,844,149,916,98,72,340,7056,1.3611111111111112,121.60592090848209
2651,792,14575,54,847,135,911,81,64,290,5184,1.265625,103.23274674249446
2652,1107,14575,53,846,133,903,80,57,274,4560,1.4035087719298245,98.22932352408826
2653,884,33304,89,1298,408,1574,319,276,1190,88044,1.1557971014492754,421.82579342662297
2654,285,33304,103,1297,467,1587,364,290,1308,105560,1.2551724137931035,465.3987537585377
2655,272,33304,95,1301,469,1587,374,286,1320,106964,1.3076923076923077,470.82056029871933
2656,917,13526,111,396,531,724,420,328,1496,137760,1.2804878048780488,532.9014918350294
2657,831,13526,38,388,527,729,489,341,1660,166749,1.4340175953079182,596.1560198471537
2658,1212,13526,108,441,469,675,361,234,1190,84474,1.5427350427350428,430.20576472195256
2659,126,12338,57,768,163,824,106,56,324,5936,1.8928571428571428,119.88327656516567
2660,421,12338,73,772,168,814,95,42,274,3990,2.261904761904762,103.87011119662864
2661,337,12338,56,770,163,818,107,48,310,5136,2.2291666666666665,117.27318534089538
2662,1598,16228,14,370,292,628,278,258,1072,71724,1.0775193798449612,379.27298875612007
2663,1117,16228,30,376,287,621,257,245,1004,62965,1.0489795918367346,355.0690073774392
2664,1107,16228,21,377,283,614,262,237,998,62094,1.1054852320675106,353.28883367579
2665,421,9713,42,614,379,1051,337,437,1548,147269,0.7711670480549199,551.8496171965693
2666,13,9713,35,587,379,1036,344,449,1586,154456,0.7661469933184856,565.6297375492204
2667,25,9713,85,722,296,868,211,146,714,30806,1.4452054794520548,256.587217140683
2668,1277,9713,85,657,374,1012,289,355,1288,102595,0.8140845070422535,457.7619468675831
2669,71,9713,54,595,360,1068,306,473,1558,144738,0.6469344608879493,563.3515776138379
2670,1719,9713,55,578,353,1012,298,434,1464,129332,0.6866359447004609,526.4598750142312
2671,1231,9713,66,591,385,1038,319,447,1532,142593,0.7136465324384788,549.1538946415659
2672,748,9713,45,666,369,960,324,294,1236,95256,1.1020408163265305,437.5065713792194
2673,641,9713,42,604,381,1041,339,437,1552,148143,0.7757437070938215,553.0732320407488
2674,1279,9713,49,635,357,992,308,357,1330,109956,0.8627450980392157,471.5007953333695
2675,931,9454,228,295,429,587,201,292,986,58692,0.6883561643835616,354.4925951271761
2676,841,9454,236,274,501,608,265,334,1198,88510,0.7934131736526946,426.3578309354714
2677,384,9454,223,273,515,606,292,333,1250,97236,0.8768768768768769,442.89163460151286
2678,1319,9454,149,265,502,639,353,374,1454,132022,0.9438502673796793,514.2810515661646
2679,886,9454,238,291,466,577,228,286,1028,65208,0.7972027972027972,365.75948381415895
2680,1269,9454,237,242,508,632,271,390,1322,105690,0.6948717948717948,474.911570716065
2681,1300,10167,152,762,338,992,186,230,832,42780,0.8086956521739129,295.79722784367
2682,261,10167,172,800,340,898,168,98,532,16464,1.7142857142857142,194.49421585229726
2683,1081,10167,55,774,452,1074,397,300,1394,119100,1.3233333333333333,497.6032556163595
2684,831,10167,112,778,458,990,346,212,1116,73352,1.6320754716981132,405.7831933434405
2685,659,10167,146,780,446,1016,300,236,1072,70800,1.2711864406779658,381.70145401871343
2686,443,10167,140,780,338,1006,198,226,848,44748,0.8761061946902655,300.4663042672173
2687,1210,10167,129,776,452,1098,323,322,1290,104006,1.0031055900621118,456.0844220097854
2688,1460,10167,69,772,430,1310,361,538,1798,194218,0.6710037174721191,647.892738036166
2689,119,1473,147,949,298,1106,151,157,616,23707,0.961783439490446,217.83020910791964
2690,1602,1473,77,884,326,1166,249,282,1062,70218,0.8829787234042553,376.19808611953357
2691,1601,1473,151,1000,239,1088,88,88,352,7744,1.0,124.45079348883236
2692,279,1473,102,905,325,1152,223,247,940,55081,0.9028340080971659,332.77319603597886
2693,886,1473,132,932,326,1168,194,236,860,45784,0.8220338983050848,305.50286414369344
2694,935,1473,75,898,339,1170,264,272,1072,71808,0.9705882352941176,379.0514476954283
2695,1413,1473,141,942,314,1144,173,202,750,34946,0.8564356435643564,265.9567634033773
2696,1607,1473,131,924,336,1168,205,244,898,50020,0.8401639344262295,318.6863661972379
2697,1426,17285,74,863,395,1118,321,255,1152,81855,1.258823529411765,409.9585344885504
2698,738,17285,54,877,398,1105,344,228,1144,78432,1.5087719298245614,412.6984371184364
2699,1375,17285,75,906,333,1089,258,183,882,47214,1.4098360655737705,316.3115552742264
2700,806,8836,45,831,525,1114,480,283,1526,135840,1.6961130742049468,557.2153982079103
2701,140,8836,46,857,482,1124,436,267,1406,116412,1.632958801498127,511.2582517671475
2702,1671,8836,69,846,534,1137,465,291,1512,135315,1.5979381443298968,548.5489950770123
2703,909,8836,48,849,492,1081,444,232,1352,103008,1.913793103448276,500.9590801652366
2704,1560,8836,44,886,481,1076,437,190,1254,83030,2.3,476.5175757514092
2705,809,8836,39,839,502,1103,463,264,1454,122232,1.7537878787878791,532.977485453185
2706,861,8836,82,848,504,1122,422,274,1392,115628,1.54014598540146,503.15007701480084
2707,1384,8836,56,829,510,1145,454,316,1540,143464,1.4367088607594938,553.1473583051808
2708,905,8836,190,930,477,1100,287,170,914,48790,1.688235294117647,333.5700825913499
2709,1328,15247,137,121,727,587,590,466,2112,274940,1.2660944206008584,751.8350883006193
2710,1432,15247,78,261,827,590,749,329,2156,246421,2.276595744680851,818.0721239597399
2711,1657,15247,159,113,806,601,647,488,2270,315736,1.3258196721311477,810.4029861741626
2712,800,19237,66,772,643,1302,577,530,2214,305810,1.0886792452830192,783.4723990033089
2713,891,19237,27,676,653,1302,626,626,2504,391876,1.0,885.2976900455575
2714,952,19237,91,873,516,1265,425,392,1634,166600,1.0841836734693877,578.1773084443906
2715,240,19237,130,826,484,1230,354,404,1516,143016,0.8762376237623762,537.1517476467893
2716,1185,19237,43,733,634,1287,591,554,2290,327414,1.0667870036101084,810.0598743302868
2717,894,19237,89,733,517,1146,428,413,1682,176764,1.036319612590799,594.7713846512793
2718,944,19237,58,823,580,1239,522,416,1876,217152,1.2548076923076923,667.4878276043692
2719,1610,19237,142,832,427,1188,285,356,1282,101460,0.8005617977528091,456.0274114568114
2720,857,3143,214,183,926,710,712,527,2478,375224,1.3510436432637571,885.81770133589
2721,903,3143,73,151,983,768,910,617,3054,561470,1.4748784440842788,1099.449407658215
2722,356,3143,100,183,890,684,790,501,2582,395790,1.5768463073852297,935.4683319065376
2723,1359,577,63,1041,143,1104,80,63,286,5040,1.2698412698412698,101.82828683622247
2724,555,577,64,1043,137,1101,73,58,262,4234,1.2586206896551724,93.23625904121208
2725,831,577,64,1035,152,1108,88,73,322,6424,1.2054794520547945,114.33722053644648
2726,984,577,79,1056,115,1095,36,39,150,1404,0.9230769230769232,53.075418038862395
2727,877,577,70,1037,148,1104,78,67,290,5226,1.164179104477612,102.82509421342633
2728,1750,577,61,1042,140,1099,79,57,272,4503,1.3859649122807018,97.41663102366043
2729,1243,577,68,1036,141,1107,73,71,288,5183,1.028169014084507,101.83319694480774
2730,1470,24077,532,876,807,1283,275,407,1364,111925,0.6756756756756757,491.19649835885434
2731,1700,24077,265,840,843,1309,578,469,2094,271082,1.232409381663113,744.3419912916374
2732,119,24077,533,846,840,1291,307,445,1504,136615,0.6898876404494382,540.6237138713026
2733,387,24077,562,865,764,1294,202,429,1262,86658,0.4708624708624709,474.17823653137015
2734,1364,24077,538,863,813,1220,275,357,1264,98175,0.7703081232492998,450.6373264610911
2735,1595,24077,519,865,790,1105,271,240,1022,65040,1.1291666666666669,361.99585632987566
2736,611,24077,524,876,800,1287,276,411,1374,113436,0.6715328467153284,495.07272193082906
2737,620,24077,473,898,916,1335,443,437,1760,193591,1.0137299771167048,622.2684308238688
2738,1223,24077,488,855,847,1311,359,456,1630,163704,0.7872807017543859,580.3593714242926
2739,788,24077,540,891,773,1237,233,346,1158,80618,0.6734104046242775,417.1390655404981
2740,1508,31101,34,766,84,815,50,49,198,2450,1.020408163265306,70.00714249274856
2741,813,31101,36,775,92,816,56,41,194,2296,1.3658536585365857,69.40461079784254
2742,909,31101,43,769,79,812,36,43,158,1548,0.8372093023255814,56.08029957123981
2743,1727,31101,32,769,86,812,54,43,194,2322,1.255813953488372,69.02897942168927
2744,433,31101,34,769,73,813,39,44,166,1716,0.8863636363636364,58.7962583843564
2745,207,31101,53,768,82,793,29,25,108,725,1.16,38.28837943815329
2746,1031,8747,55,571,966,1168,911,597,3016,543867,1.5259631490787269,1089.187770772331
2747,265,8747,41,573,1023,1216,982,643,3250,631426,1.5272161741835149,1173.78575557893
2748,1685,8747,81,594,920,1182,839,588,2854,493332,1.4268707482993197,1024.5316002935194
2749,1684,1032,51,447,184,560,133,113,492,15029,1.1769911504424782,174.52220489095365
2750,1400,1032,61,441,190,556,129,115,488,14835,1.1217391304347826,172.81782315490494
2751,1157,1032,45,478,164,565,119,87,412,10353,1.367816091954023,147.41099009232656
2752,660,21656,145,808,424,1014,279,206,970,57474,1.354368932038835,346.8097461144943
2753,1461,21656,90,775,424,1035,334,260,1188,86840,1.2846153846153847,423.2682364647742
2754,1158,21656,63,780,457,1048,394,268,1324,105592,1.4701492537313432,476.5081321446676
2755,1378,23609,148,635,243,742,95,107,404,10165,0.8878504672897196,143.0873858870865
2756,1483,23609,88,621,222,706,134,85,438,11390,1.5764705882352938,158.68522300453813
2757,957,23609,98,613,255,707,157,94,502,14758,1.6702127659574468,182.98907071188705
2758,1010,23609,81,601,241,725,160,124,568,19840,1.2903225806451613,202.4252948620799
2759,15,23609,32,596,321,777,289,181,940,52309,1.5966850828729282,341.0014662725074
2760,576,23609,69,604,314,776,245,172,834,42140,1.4244186046511629,299.34762400927787
2761,120,23609,65,605,249,754,184,149,666,27416,1.2348993288590604,236.76359517459605
2762,1183,29200,72,199,873,794,801,595,2792,476595,1.346218487394958,997.8106032709815
2763,239,29200,164,250,707,737,543,487,2060,264441,1.1149897330595482,729.3956402392325
2764,852,29200,120,261,845,800,725,539,2528,390775,1.3450834879406308,903.4079919947576
2765,744,29200,144,223,833,739,689,516,2410,355524,1.3352713178294573,860.8002091077813
2766,10,29200,153,251,744,801,591,550,2282,325050,1.0745454545454545,807.3295485735673
2767,577,29200,132,288,846,796,714,508,2444,362712,1.4055118110236222,876.2762121614394
2768,1470,24950,101,472,360,716,259,244,1006,63196,1.0614754098360657,355.8328259168904
2769,620,24950,77,438,354,716,277,278,1110,77006,0.9964028776978416,392.44490059115304
2770,119,24950,84,465,361,725,277,260,1074,72020,1.0653846153846154,379.90656746100086
2771,1244,32477,32,431,336,720,304,289,1186,87856,1.0519031141868511,419.4484473686844
2772,1684,32477,54,429,327,708,273,279,1104,76167,0.9784946236559141,390.3460003637798
2773,656,32477,21,418,331,700,310,282,1184,87420,1.0992907801418441,419.07517225433435
2774,182,3412,88,829,265,1087,177,258,870,45666,0.686046511627907,312.8785706947665
2775,407,3412,125,837,237,976,112,139,502,15568,0.8057553956834532,178.5077029150283
2776,464,3412,99,853,256,953,157,100,514,15700,1.57,186.14241859393576
2777,577,3412,82,845,235,1049,153,204,714,31212,0.75,255.0
2778,889,3412,121,842,265,1072,144,230,748,33120,0.6260869565217392,271.3595400939499
2779,335,3412,91,823,248,980,157,157,628,24649,1.0,222.03152929257593
2780,242,3412,44,833,286,1097,242,264,1012,63888,0.9166666666666666,358.13405311419353
2781,1227,3412,77,823,277,1029,200,206,812,41200,0.9708737864077671,287.1167010119753
2782,129,3412,70,835,253,985,183,150,666,27450,1.22,236.61994844053194
2783,1449,2001,209,843,348,1043,139,200,678,27800,0.695,243.55902775302746
2784,1146,2001,186,859,335,962,149,103,504,15347,1.4466019417475728,181.13530854032848
2785,1199,2001,218,875,319,991,101,116,434,11716,0.8706896551724138,153.8083222715858
2786,427,2001,200,851,325,977,125,126,502,15750,0.992063492063492,177.48521065147935
2787,1384,2001,187,844,320,1033,133,189,644,25137,0.7037037037037037,231.10603626906848
2788,94,2001,194,852,323,974,129,122,502,15738,1.0573770491803278,177.55280904564702
2789,263,19871,58,612,608,994,550,382,1864,210100,1.4397905759162304,669.6446819022757
2790,1623,19871,97,627,632,974,535,347,1764,185645,1.54178674351585,637.6786024322911
2791,779,19871,86,643,639,968,553,325,1756,179725,1.7015384615384614,641.4312122121904
2792,1158,19871,117,612,639,1024,522,412,1868,215064,1.266990291262136,665.0022556352723
2793,1212,19871,73,606,426,847,353,241,1188,85073,1.4647302904564314,427.4225075964063
2794,1214,19871,73,658,637,966,564,308,1744,173712,1.8311688311688312,642.6196386666065
2795,1602,35962,79,447,586,902,507,455,1924,230685,1.1142857142857143,681.2297703418429
2796,1698,35962,108,538,369,816,261,278,1078,72558,0.9388489208633094,381.3200755271088
2797,1046,35962,84,527,394,854,310,327,1274,101370,0.9480122324159022,450.5873944086763
2798,279,35962,60,524,467,907,407,383,1580,155881,1.0626631853785902,558.8720783864586
2799,886,35962,57,555,458,899,401,344,1490,137944,1.1656976744186047,528.3341745524323
2800,1408,35962,85,514,376,882,291,368,1318,107088,0.7907608695652174,469.1534930062868
2801,968,11979,285,984,530,1207,245,223,936,54635,1.0986547085201794,331.291412505667
2802,909,11979,263,967,434,1089,171,122,586,20862,1.401639344262295,210.05951537600004
2803,1497,11979,348,1008,489,1201,141,193,668,27213,0.7305699481865285,239.0188277102873
2804,963,11979,324,966,480,1151,156,185,682,28860,0.8432432432432433,241.99380157351138
2805,437,11979,369,1011,447,1077,78,66,288,5148,1.181818181818182,102.17631819555841
2806,199,11979,316,998,512,1143,196,145,682,28420,1.3517241379310343,243.80525014855607
2807,810,11979,307,994,530,1155,223,161,768,35903,1.3850931677018634,275.04545078950133
2808,650,11979,315,982,527,1195,212,213,850,45156,0.9953051643192488,300.5212138934621
2809,1389,11979,238,916,586,1210,348,294,1284,102312,1.1836734693877549,455.5655825454772
2810,142,11979,347,990,465,1113,118,123,482,14514,0.9593495934959351,170.4494059831245
2811,1668,11979,312,983,542,1163,230,180,820,41400,1.2777777777777777,292.0616373302047
2812,251,24164,70,527,442,775,372,248,1240,92256,1.5,447.0883581575347
2813,140,24164,87,625,424,741,337,116,906,39092,2.905172413793104,356.4056677439347
2814,592,24164,42,565,441,763,399,198,1194,79002,2.015151515151515,445.4267616567285
2815,1555,24164,97,563,357,750,260,187,894,48620,1.390374331550802,320.2639536382451
2816,971,24164,50,575,435,759,385,184,1138,70840,2.092391304347826,426.7095030579938
2817,1654,32050,215,1003,357,1144,142,141,566,20022,1.0070921985815602,200.11246837716035
2818,237,32050,208,946,653,1261,445,315,1520,140175,1.4126984126984128,545.2063829413592
2819,525,32050,256,986,736,1208,480,222,1404,106560,2.1621621621621623,528.8515859860875
2820,957,32050,223,1008,409,1159,186,151,674,28086,1.2317880794701987,239.57671005337727
2821,689,32050,173,929,871,1318,698,389,2174,271522,1.7943444730077118,799.0775932285925
2822,1281,32050,201,959,876,1290,675,331,2012,223425,2.039274924471299,751.7885340971887
2823,191,32050,210,1007,692,1211,482,204,1372,98328,2.362745098039216,523.3927779402387
2824,729,21732,311,839,565,1110,254,271,1050,68834,0.9372693726937268,371.42563185649965
2825,1476,21732,310,878,523,1064,213,186,798,39618,1.1451612903225807,282.78083386255156
2826,678,21732,289,817,573,1153,284,336,1240,95424,0.8452380952380952,439.94545116411877
2827,1173,21732,320,895,544,1102,224,207,862,46368,1.0821256038647342,305.0
2828,179,21732,241,820,623,1175,382,355,1474,135610,1.0760563380281691,521.4872961060508
2829,58,21732,311,861,548,1149,237,288,1050,68256,0.8229166666666666,372.9785516621566
2830,62,30089,28,418,309,600,281,182,926,51142,1.543956043956044,334.79097956784915
2831,1370,30089,34,412,297,603,263,191,908,50233,1.3769633507853405,325.0384592629002
2832,178,30089,28,407,277,588,249,181,860,45069,1.3756906077348066,307.8343710504076
2833,382,1571,53,750,180,858,127,108,470,13716,1.1759259259259258,166.71232707871366
2834,1400,1571,90,747,173,846,83,99,364,8217,0.8383838383838383,129.18978287774928
2835,1360,1571,56,742,189,865,133,123,512,16359,1.08130081300813,181.1573901335521
2836,379,1571,99,763,161,853,62,90,304,5580,0.6888888888888889,109.288608738514
2837,1690,1571,87,761,181,862,94,101,390,9494,0.9306930693069309,137.97463535012514
2838,831,1571,79,745,193,864,114,119,466,13566,0.9579831932773109,164.7938105633825
2839,664,14681,80,978,211,1119,131,141,544,18471,0.9290780141843972,192.46298345396187
2840,552,14681,83,975,195,1114,112,139,502,15568,0.8057553956834532,178.5077029150283
2841,161,14681,53,970,212,1117,159,147,612,23373,1.0816326530612246,216.54098919142305
2842,656,32493,36,781,473,1165,437,384,1642,167808,1.1380208333333333,581.743070435738
2843,874,32493,74,843,487,1144,413,301,1428,124313,1.372093023255814,511.0479429564314
2844,1351,32493,127,831,459,1161,332,330,1324,109560,1.0060606060606059,468.10682541488325
2845,202,11703,30,314,176,410,146,96,484,14016,1.5208333333333333,174.73408368146153
2846,299,11703,41,319,228,513,187,194,762,36278,0.963917525773196,269.45314991664134
2847,1508,11703,40,369,221,535,181,166,694,30046,1.0903614457831323,245.5951953927438
2848,909,11703,86,326,210,526,124,200,648,24800,0.62,235.32105728132365
2849,1665,11703,51,310,228,537,177,227,808,40179,0.7797356828193832,287.8506557227202
2850,1565,11703,42,319,209,551,167,232,798,38744,0.7198275862068966,285.8548582760139
2851,1163,22626,20,496,258,727,238,231,938,54978,1.0303030303030305,331.6700167334997
2852,55,22626,22,520,248,721,226,201,854,45426,1.1243781094527363,302.4516490284025
2853,1097,22626,22,502,272,751,250,249,998,62250,1.0040160642570282,352.8469923352047
2854,889,2776,108,193,651,572,543,379,1844,205797,1.4327176781002642,662.1857745376293
2855,1554,2776,11,148,661,572,650,424,2148,275600,1.5330188679245282,776.0644303149063
2856,577,2776,182,221,657,571,475,350,1650,166250,1.3571428571428572,590.0211860602973
2857,32,31331,45,850,419,1449,374,599,1946,224026,0.6243739565943238,706.1706592602103
2858,1508,31331,71,909,415,1328,344,419,1526,144136,0.8210023866348448,542.1226798428562
2859,1139,31331,43,861,431,1441,388,580,1936,225040,0.6689655172413793,697.8137287270866
2860,872,32281,38,496,60,522,22,26,96,572,0.8461538461538461,34.058772731852805
2861,161,32281,27,488,66,533,39,45,168,1755,0.8666666666666667,59.54829972383762
2862,379,32281,34,497,62,533,28,36,128,1008,0.7777777777777778,45.60701700396552
2863,107,32281,34,491,64,534,30,43,146,1290,0.6976744186046512,52.43090691567332
2864,1468,32281,36,492,64,529,28,37,130,1036,0.7567567567567568,46.400431032480725
2865,1467,4236,89,240,656,1019,567,779,2692,441693,0.7278562259306803,963.4988323812333
2866,152,4236,89,246,598,889,509,643,2304,327287,0.7916018662519441,820.0792644616738
2867,1097,4236,13,174,695,1079,682,905,3174,617210,0.7535911602209945,1133.2029826999221
2868,543,4236,47,251,602,1078,555,827,2764,458985,0.6711003627569528,995.9688750156804
2869,1092,4236,33,267,609,1097,576,830,2812,478080,0.6939759036144578,1010.2851082738971
2870,1271,33896,102,816,635,1272,533,456,1978,243048,1.1688596491228072,701.4449372545217
2871,925,33896,27,836,679,1261,652,425,2154,277100,1.5341176470588236,778.2859371721938
2872,1222,33896,316,760,694,1217,378,457,1670,172746,0.8271334792122538,593.0708220777684
2873,119,33896,156,829,745,1223,589,394,1966,232066,1.4949238578680204,708.6303690923781
2874,1316,33896,488,833,714,1144,226,311,1074,70286,0.7266881028938906,384.44375401350976
2875,929,33896,21,785,662,1232,641,447,2176,286527,1.4340044742729303,781.4665699823634
2876,995,33896,31,844,699,1335,668,491,2318,327988,1.3604887983706722,829.0385998251228
2877,318,33896,485,897,702,1055,217,158,750,34286,1.3734177215189871,268.4268988011447
2878,115,26395,112,864,381,1103,269,239,1016,64291,1.1255230125523012,359.83607378916304
2879,1311,26395,84,858,423,1089,339,231,1140,78309,1.4675324675324677,410.22189117598293
2880,1698,26395,201,893,361,1061,160,168,656,26880,0.9523809523809524,232.0
2881,1643,26395,108,847,385,1086,277,239,1032,66203,1.1589958158995817,365.8551625985343
2882,400,26395,148,869,360,1079,212,210,844,44520,1.0095238095238095,298.40241285887754
2883,1707,26395,138,893,370,1062,232,169,802,39208,1.3727810650887573,287.0278732109479
2884,1554,2746,30,375,924,982,894,607,3002,542658,1.472817133443163,1080.594743648145
2885,520,2746,251,378,782,978,531,600,2262,318600,0.885,801.2246875876954
2886,579,2746,191,384,875,845,684,461,2290,315324,1.4837310195227766,824.8496832756863
2887,577,2746,169,370,734,984,565,614,2358,346910,0.9201954397394136,834.3985858089645
2888,404,2746,151,387,803,894,652,507,2318,330564,1.2859960552268244,825.9255414382098
2889,1006,2746,105,384,805,972,700,588,2576,411600,1.1904761904761905,914.1903521696124
2890,1651,2746,96,407,770,975,674,568,2484,382832,1.1866197183098592,881.4193099768123
2891,889,2746,108,385,904,964,796,579,2750,460884,1.374784110535406,984.3053388049868
2892,905,9027,158,426,897,772,739,346,2170,255694,2.1358381502890174,815.9883577600847
2893,809,9027,136,407,801,756,665,349,2028,232085,1.9054441260744983,751.0166442895923
2894,140,9027,172,446,850,740,678,294,1944,199332,2.3061224489795915,738.9993234097038
2895,806,9027,145,380,914,811,769,431,2400,331439,1.7842227378190256,881.5452342336155
2896,909,9027,541,403,812,774,271,371,1284,100541,0.7304582210242587,459.436611514581
2897,1671,9027,200,399,834,738,634,339,1946,214926,1.870206489675516,718.9415831623596
2898,903,667,197,66,738,444,541,378,1838,204498,1.4312169312169312,659.9734843158474
2899,141,667,221,74,894,538,673,464,2274,312272,1.450431034482759,817.4503042999005
2900,366,667,159,75,875,551,716,476,2384,340816,1.5042016806722691,859.7860198909959
2901,1391,7458,84,738,247,846,163,108,542,17604,1.5092592592592593,195.5326059765992
2902,362,7458,65,736,259,849,194,113,614,21922,1.7168141592920354,224.51057881534223
2903,1389,7458,41,732,257,855,216,123,678,26568,1.7560975609756098,248.5658866377283
2904,1396,4257,32,646,71,667,39,21,120,819,1.8571428571428568,44.294469180700204
2905,1357,4257,34,642,76,682,42,40,164,1680,1.05,58.0
2906,1404,4257,29,641,80,683,51,42,186,2142,1.2142857142857142,66.06814663663572
2907,1401,4257,34,650,69,671,35,21,112,735,1.6666666666666667,40.8166632639171
2908,873,4257,31,644,80,682,49,38,174,1862,1.2894736842105263,62.00806399170998
2909,100,4257,25,642,82,683,57,41,196,2337,1.3902439024390243,70.21395872616783
2910,689,31932,21,282,625,649,604,367,1942,221668,1.6457765667574933,706.7566766575326
2911,947,31932,46,277,641,632,595,355,1900,211225,1.676056338028169,692.8564064797265
2912,577,31932,72,288,638,646,566,358,1848,202628,1.5810055865921788,669.716357871002
2913,819,4538,92,768,121,781,29,13,84,377,2.230769230769231,31.78049716414141
2914,294,4538,123,822,910,1365,787,543,2660,427341,1.4493554327808469,956.1474781643259
2915,1508,4538,37,996,370,1287,333,291,1248,96903,1.1443298969072164,442.2329702769797
2916,1389,4538,60,800,933,1416,873,616,2978,537768,1.417207792207792,1068.4498116430177
2917,1221,20275,60,546,940,1201,880,655,3070,576400,1.3435114503816794,1097.0072925919865
2918,1362,20275,564,591,779,1071,215,480,1390,103200,0.4479166666666667,525.9515186782903
2919,886,20275,48,554,911,1183,863,629,2984,542827,1.3720190779014307,1067.899808034443
2920,227,20275,101,571,1008,1171,907,600,3014,544200,1.5116666666666667,1087.496666661558
2921,1321,20275,488,544,946,1050,458,506,1928,231748,0.9051383399209486,682.4954212300622
2922,1636,20275,348,625,811,1100,463,475,1876,219925,0.9747368421052632,663.320435385493
2923,174,20275,53,560,940,1099,887,539,2852,478093,1.6456400742115027,1037.9258162315841
2924,12,25162,147,678,800,1208,653,530,2366,346090,1.2320754716981133,841.0166466842378
2925,941,25162,204,703,875,1196,671,493,2328,330803,1.3610547667342798,832.6403785548716
2926,189,25162,71,678,901,1225,830,547,2754,454010,1.517367458866545,994.0367196436961
2927,1709,25162,132,651,850,1181,718,530,2496,380540,1.3547169811320754,892.4259072886667
2928,1123,25162,210,664,860,1204,650,540,2380,351000,1.2037037037037035,845.0443775329198
2929,952,25162,287,724,617,1057,330,333,1326,109890,0.990990990990991,468.8165952694081
2930,1138,28802,55,1158,595,1487,540,329,1738,177660,1.641337386018237,632.32981900271
2931,907,28802,64,1158,600,1474,536,316,1704,169376,1.6962025316455696,622.2153967879613
2932,252,28802,64,1165,603,1455,539,290,1658,156310,1.8586206896551725,612.0629052638299
2933,94,35492,111,676,219,828,108,152,520,16416,0.7105263157894737,186.46179233290664
2934,1674,35492,107,664,192,827,85,163,496,13855,0.5214723926380368,183.83144453547658
2935,33,35492,119,685,237,789,118,104,444,12272,1.1346153846153846,157.2895419282541
2936,1508,35492,94,700,226,828,132,128,520,16896,1.03125,183.86951895297926
2937,200,35492,66,682,228,853,162,171,666,27702,0.9473684210526316,235.55254190944322
2938,1371,3777,40,82,623,795,583,713,2592,415679,0.8176718092566619,921.0092290525649
2939,1263,3777,28,67,560,790,532,723,2510,384636,0.73582295988935,897.6374546552745
2940,1635,3777,42,90,628,780,586,690,2552,404340,0.8492753623188406,905.2601835936451
2941,462,3777,151,246,507,581,356,335,1382,119260,1.0626865671641792,488.83637344207517
2942,562,3777,55,72,581,799,526,727,2506,382402,0.7235213204951857,897.332157007649
2943,1045,3777,29,152,627,743,598,591,2378,353418,1.011844331641286,840.7645330293137
2944,1145,20483,133,463,647,808,514,345,1718,177330,1.489855072463768,619.0484633693876
2945,592,20483,31,405,643,762,612,357,1938,218484,1.7142857142857142,708.5146434619401
2946,1559,20483,25,403,639,824,614,421,2070,258494,1.4584323040380047,744.4709530935374
2947,805,22326,105,462,424,665,319,203,1044,64757,1.5714285714285714,378.1137395017536
2948,93,22326,111,486,394,663,283,177,920,50091,1.5988700564971752,333.79334924470857
2949,1508,22326,164,451,361,687,197,236,866,46492,0.8347457627118644,307.4166553718259
2950,1699,6219,77,458,242,687,165,229,788,37785,0.7205240174672489,282.25166075685013
2951,559,6219,91,477,200,600,109,123,464,13407,0.8861788617886179,164.34719346554112
2952,886,6219,63,457,221,683,158,226,768,35708,0.6991150442477876,275.7535131235865
2953,1045,6219,60,481,213,634,153,153,612,23409,1.0,216.37467504308356
2954,5,6219,67,470,203,677,136,207,686,28152,0.6570048309178744,247.67922803497268
2955,1473,6219,83,476,205,673,122,197,638,24034,0.6192893401015228,231.71750041807374
2956,141,30,96,367,97,369,1,2,6,2,0.5,2.23606797749979
2957,1573,30,124,374,286,468,162,94,512,15228,1.7234042553191489,187.29655629509048
2958,1565,30,65,375,324,477,259,102,722,26418,2.5392156862745097,278.36127604248406
2959,1508,30,85,359,323,491,238,132,740,31416,1.8030303030303032,272.15436796053814
2960,903,30,87,353,316,491,229,138,734,31602,1.6594202898550725,267.36678926149375
2961,7,33024,47,642,657,843,610,201,1622,122610,3.0348258706467663,642.2624074317288
2962,58,33024,135,881,527,976,392,95,974,37240,4.126315789473685,403.3472449391467
2963,934,33024,55,635,653,1123,598,488,2172,291824,1.225409836065574,771.847135124566
2964,1046,33024,131,691,573,1127,442,436,1756,192712,1.0137614678899085,620.8542502069225
2965,884,33024,41,632,639,1126,598,494,2184,295412,1.2105263157894737,775.6545622891675
2966,455,33024,109,676,509,985,400,309,1418,123600,1.2944983818770226,505.45128350811416
2967,937,33024,140,675,525,1068,385,393,1556,151305,0.979643765903308,550.1581590779147
2968,1270,33024,210,750,598,930,388,180,1136,69840,2.1555555555555554,427.71953427450563
2969,1046,35703,79,493,284,643,205,150,710,30750,1.3666666666666667,254.01771591761076
2970,886,35703,29,463,375,662,346,199,1090,68854,1.7386934673366834,399.1453369388148
2971,615,35703,45,454,313,652,268,198,932,53064,1.3535353535353536,333.208643345277
2972,1704,35703,34,427,369,656,335,229,1128,76715,1.4628820960698692,405.79058638662383
2973,1698,35703,101,456,266,657,165,201,732,33165,0.8208955223880597,260.049995193232
2974,169,35703,82,449,297,645,215,196,822,42140,1.0969387755102042,290.93126335957777
2975,29,8387,229,804,476,1100,247,296,1086,73112,0.8344594594594594,385.5191305240247
2976,421,8387,297,813,518,1125,221,312,1066,68952,0.7083333333333334,382.3414704161713
2977,748,8387,301,800,480,1072,179,272,902,48688,0.6580882352941176,325.61480310329875
2978,61,27420,167,192,590,600,423,408,1662,172584,1.036764705882353,587.7014548220891
2979,619,27420,138,167,555,648,417,481,1796,200577,0.8669438669438669,636.5924913160695
2980,993,27420,153,218,538,526,385,308,1386,118580,1.25,493.04056628232934
2981,247,22891,120,1069,188,1120,68,51,238,3468,1.3333333333333333,85.0
2982,1350,22891,41,1043,354,1280,313,237,1100,74181,1.320675105485232,392.60412631555465
2983,91,22891,114,1062,190,1268,76,206,564,15656,0.36893203883495146,219.57231155134292
2984,488,22891,74,1058,220,1261,146,203,698,29638,0.7192118226600985,250.04999500099976
2985,1135,22891,120,1066,175,1245,55,179,468,9845,0.30726256983240224,187.2591786802452
2986,298,22891,125,1061,178,1152,53,91,288,4823,0.5824175824175825,105.30906893520614
2987,1241,22891,128,1078,169,1189,41,111,304,4551,0.36936936936936937,118.33004690272035
2988,141,5,210,925,483,1255,273,330,1206,90090,0.8272727272727273,428.2861193174488
2989,903,5,151,917,511,1160,360,243,1206,87480,1.4814814814814814,434.33742643249155
2990,1723,5,192,914,510,1331,318,417,1470,132606,0.7625899280575541,524.4168189522529
2991,1107,12908,309,599,858,1131,549,532,2162,292068,1.031954887218045,764.476945368531
2992,1110,12908,325,578,905,1170,580,592,2344,343360,0.9797297297297296,828.7725864192179
2993,282,12908,408,564,912,1135,504,571,2150,287784,0.882661996497373,761.614732000373
2994,178,12908,339,545,876,1131,537,586,2246,314682,0.9163822525597268,794.8364611666981
2995,3,12908,310,588,910,1180,600,592,2384,355200,1.0135135135135136,842.8902656929904
2996,1372,12908,276,580,870,1180,594,600,2388,356400,0.99,844.2961565706669
2997,676,12908,339,556,926,1160,587,604,2382,354548,0.9718543046357616,842.2499628970013
2998,391,12908,412,561,881,1113,469,552,2042,258888,0.8496376811594203,724.3376284578898
2999,450,10785,249,919,727,1313,478,394,1744,188332,1.2131979695431472,619.4513701655684
3000,660,10785,317,948,650,1281,333,333,1332,110889,1.0,470.93311627024065
3001,831,10785,324,914,722,1282,398,368,1532,146464,1.0815217391304348,542.0590373750815
3002,1383,2059,132,1139,403,1331,271,192,926,52032,1.4114583333333333,332.12196554880256
3003,1562,2059,135,1115,433,1350,298,235,1066,70030,1.2680851063829788,379.51152815164915
3004,1195,2059,137,1095,427,1370,290,275,1130,79750,1.0545454545454545,399.6561021678513
3005,704,2059,127,1111,430,1351,303,240,1086,72720,1.2625,386.53460388430943
3006,1384,2059,118,1127,437,1350,319,223,1084,71137,1.4304932735426008,389.21716303369766
3007,889,2780,140,536,527,730,387,194,1162,75078,1.9948453608247425,432.90299144265566
3008,331,2780,124,498,534,705,410,207,1234,84870,1.9806763285024156,459.29184621545375
3009,404,2780,126,485,421,671,295,186,962,54870,1.586021505376344,348.742024998422
3010,577,2780,91,475,425,699,334,224,1116,74816,1.4910714285714286,402.15917246781777
3011,192,2780,113,527,384,731,271,204,950,55284,1.3284313725490196,339.2005306599623
3012,1554,2780,21,476,563,835,542,359,1802,194578,1.50974930362117,650.1115288933123
3013,1437,2780,84,474,446,687,362,213,1150,77106,1.699530516431925,420.0154759053528
3014,1614,20309,85,577,312,793,227,216,886,49032,1.0509259259259258,313.3448579440869
3015,843,20309,152,589,315,711,163,122,570,19886,1.3360655737704918,203.60009823180343
3016,351,20309,250,625,272,657,22,32,108,704,0.6875,38.8329756778952
3017,1281,20309,70,594,312,790,242,196,876,47432,1.2346938775510203,311.4161203277698
3018,234,20309,221,589,313,688,92,99,382,9108,0.9292929292929292,135.14806694880988
3019,291,20309,242,629,325,689,83,60,286,4980,1.3833333333333333,102.41581909060729
3020,854,20309,80,599,256,793,176,194,740,34144,0.9072164948453608,261.9389241789009
3021,580,20309,64,582,344,786,280,204,968,57120,1.3725490196078431,346.433254754794
3022,399,16356,15,471,563,849,548,378,1852,207144,1.4497354497354498,665.7236663962008
3023,503,16356,19,471,578,896,559,425,1968,237575,1.3152941176470587,702.2150667708576
3024,225,16356,31,446,524,837,493,391,1768,192763,1.2608695652173914,629.2296877929394
3025,1416,16356,33,491,576,852,543,361,1808,196023,1.5041551246537397,652.0506115325711
3026,1708,16356,18,446,668,913,650,467,2234,303550,1.39186295503212,800.3680403414419
3027,857,3118,99,1161,741,1499,642,338,1960,216996,1.8994082840236688,725.5397990461998
3028,1619,3118,53,1176,779,1517,726,341,2134,247566,2.129032258064516,802.0953808619022
3029,903,3118,393,1104,796,1539,403,435,1676,175305,0.9264367816091954,592.987352310317
3030,428,3118,74,1063,705,1528,631,465,2192,293415,1.356989247311828,783.8277872083893
3031,807,3118,247,1211,785,1493,538,282,1640,151716,1.9078014184397163,607.4273619125171
3032,1288,3118,92,1296,719,1533,627,237,1728,148599,2.6455696202531644,670.2969491203133
3033,1383,3118,96,1211,785,1509,689,298,1974,205322,2.3120805369127515,750.68302232034
3034,847,29498,18,301,271,487,253,186,878,47058,1.3602150537634408,314.0143308831621
3035,952,29498,28,338,267,491,239,153,784,36567,1.562091503267974,283.7780823108085
3036,1486,29498,59,356,260,480,201,124,650,24924,1.6209677419354838,236.17154782064668
3037,1391,7478,140,579,319,716,179,137,632,24523,1.3065693430656935,225.41073621280776
3038,1620,7478,40,563,359,759,319,196,1030,62524,1.6275510204081634,374.40219016453415
3039,1508,7478,26,606,141,756,115,150,530,17250,0.7666666666666667,189.01058171435798
3040,1442,7478,91,580,356,764,265,184,898,48760,1.4402173913043481,322.61587065735
3041,1389,7478,38,560,384,766,346,206,1104,71276,1.6796116504854368,402.68101519689253
3042,1181,8636,284,837,544,1216,260,379,1278,98540,0.6860158311345647,459.60961695769595
3043,478,8636,271,817,517,1218,246,401,1294,98646,0.6134663341645885,470.4434078611369
3044,287,8636,166,847,536,1275,370,428,1596,158360,0.8644859813084113,565.7596662894944
3045,525,8636,331,701,534,1289,203,588,1582,119364,0.34523809523809523,622.055463765089
3046,29,8636,257,789,487,1146,230,357,1174,82110,0.6442577030812325,424.6751699828941
3047,1012,8636,208,795,580,1275,372,480,1704,178560,0.775,607.2758845862397
3048,753,8636,343,808,464,939,121,131,504,15851,0.9236641221374046,178.33115263464205
3049,748,8636,246,835,522,1249,276,414,1380,114264,0.6666666666666666,497.5660760140305
3050,886,1412,25,282,862,1091,837,809,3292,677133,1.034610630407911,1164.0661493231387
3051,1602,1412,52,214,931,1141,879,927,3612,814833,0.948220064724919,1277.4858120542865
3052,1046,1412,61,369,798,1100,737,731,2936,538747,1.0082079343365251,1038.0414249922785
3053,603,25880,87,869,369,1179,282,310,1184,87420,0.9096774193548388,419.07517225433435
3054,912,25880,126,932,268,1104,142,172,628,24424,0.8255813953488372,223.0425968284982
3055,1398,25880,131,937,265,1089,134,152,572,20368,0.8815789473684209,202.63267258761604
3056,233,25880,96,919,361,1205,265,286,1102,75790,0.9265734265734266,389.8987047939503
3057,409,25880,119,950,283,1104,164,154,636,25256,1.0649350649350648,224.97110925627763
3058,955,25880,65,867,329,1160,264,293,1114,77352,0.9010238907849828,394.3919370372574
3059,1096,25880,136,917,308,1181,172,264,872,45408,0.6515151515151515,315.08728949292765
3060,1078,25880,127,912,267,1110,140,198,676,27720,0.7070707070707071,242.49536078036627
3061,1305,25880,108,912,305,1166,197,254,902,50038,0.7755905511811023,321.4420632089086
3062,15,25880,126,927,266,1113,140,186,652,26040,0.7526881720430108,232.80034364235806
3063,242,25880,114,895,342,1227,228,332,1120,75696,0.6867469879518072,402.75054314054006
3064,665,25880,106,924,262,1108,156,184,680,28704,0.8478260869565217,241.23018053303363
3065,538,25880,125,922,285,1168,160,246,812,39360,0.6504065040650406,293.4552776829887
3066,79,25880,68,881,384,1191,316,310,1252,97960,1.0193548387096774,442.66917669971104
3067,1478,25880,118,901,287,1188,169,287,912,48503,0.5888501742160279,333.0615558721841
3068,1124,25880,148,955,258,1110,110,155,530,17050,0.7096774193548387,190.06577808748213
3069,1482,25880,90,902,338,1149,248,247,990,61256,1.0040485829959511,350.0185709358862
3070,1635,25880,81,917,277,1111,196,194,780,38024,1.0103092783505154,275.7752708275345
3071,1698,25880,119,920,275,1118,156,198,708,30888,0.7878787878787878,252.07141845120006
3072,691,25880,143,934,236,1085,93,151,488,14043,0.6158940397350994,177.341478509682
3073,1046,25880,139,937,248,1111,109,174,566,18966,0.6264367816091954,205.32169880458324
3074,768,25880,105,901,315,1145,210,244,908,51240,0.860655737704918,321.9254572102057
3075,723,25880,71,909,358,1220,287,311,1196,89257,0.9228295819935692,423.19026453830435
3076,1209,25880,86,910,313,1123,227,213,880,48351,1.0657276995305165,311.28443584606026
3077,1509,16045,114,169,715,655,601,486,2174,292086,1.2366255144032925,772.9146136540569
3078,1681,16045,22,142,703,649,681,507,2376,345267,1.343195266272189,849.0053003368118
3079,657,16045,40,151,72,188,32,37,138,1184,0.8648648648648649,48.91829923454004
3080,1584,16045,35,142,684,648,649,506,2310,328394,1.2826086956521738,822.9441050277959
3081,1577,16045,70,128,412,527,342,399,1482,136458,0.8571428571428571,525.5140340656945
3082,548,16045,58,174,708,652,650,478,2256,310700,1.3598326359832635,806.8357949421927
3083,552,16045,77,178,675,574,598,396,1988,236808,1.5101010101010102,717.2307857307856
3084,1626,16045,87,154,402,457,315,303,1236,95445,1.0396039603960396,437.0743643820809
3085,1375,17240,20,432,208,607,188,175,726,32900,1.0742857142857145,256.8443108188305
3086,1647,17240,36,444,164,571,128,127,510,16256,1.0078740157480317,180.31361568112376
3087,1721,17240,21,431,203,555,182,124,612,22568,1.4677419354838708,220.22715545545242
3088,323,843,50,988,80,1014,30,26,112,780,1.1538461538461535,39.698866482558415
3089,1602,843,56,990,74,1013,18,23,82,414,0.7826086956521741,29.206163733020468
3090,886,843,47,992,78,1010,31,18,98,558,1.7222222222222223,35.84689665786984
3091,1158,20768,81,460,386,730,305,270,1150,82350,1.1296296296296295,407.3389252207552
3092,600,20768,49,456,410,717,361,261,1244,94221,1.3831417624521072,445.46829292330114
3093,1689,20768,112,469,370,708,258,239,994,61662,1.0794979079497908,351.6887828748594
3094,1156,20768,106,486,333,697,227,211,876,47897,1.0758293838862558,309.9193443462347
3095,553,20768,90,457,400,724,310,267,1154,82770,1.1610486891385767,409.13200803652603
3096,57,20768,80,460,412,714,332,254,1172,84328,1.3070866141732282,418.0191383178526
3097,821,10358,280,648,462,878,182,230,824,41860,0.7913043478260869,293.2984827782101
3098,917,10358,202,497,361,663,159,166,650,26394,0.9578313253012049,229.86300267768192
3099,1743,10358,195,487,431,817,236,330,1132,77880,0.7151515151515152,405.70432583348185
3100,831,10358,92,499,521,869,429,370,1598,158730,1.1594594594594594,566.5165487432826
3101,1212,10358,101,485,479,871,378,386,1528,145908,0.9792746113989638,540.2591970526739
3102,660,10358,189,527,485,874,296,347,1286,102712,0.8530259365994236,456.0975772792484
3103,1046,34163,45,570,153,688,108,118,452,12744,0.9152542372881356,159.9624956044385
3104,929,34163,30,567,156,691,126,124,500,15624,1.0161290322580645,176.7823520603796
3105,1529,34163,34,567,167,694,133,127,520,16891,1.0472440944881891,183.89671013914307
3106,1222,34163,83,575,145,663,62,88,300,5456,0.7045454545454546,107.64757312638311
3107,327,34163,74,564,150,691,76,127,406,9652,0.5984251968503937,148.00337833982033
3108,169,34163,41,567,158,690,117,123,480,14391,0.951219512195122,169.7586522095413
3109,391,34163,31,580,157,693,126,113,478,14238,1.1150442477876106,169.24833824885843
3110,885,27956,84,826,626,1263,542,437,1958,236854,1.2402745995423339,696.2276926408487
3111,1324,27956,46,788,728,1283,682,495,2354,337590,1.3777777777777778,842.7033879129714
3112,784,27956,117,868,540,1225,423,357,1560,151011,1.184873949579832,553.5142274594214
3113,744,27116,209,590,576,1048,367,458,1650,168086,0.8013100436681223,586.9011841869124
3114,638,27116,146,675,535,1158,389,483,1744,187887,0.8053830227743272,620.1693317151373
3115,242,27116,185,619,576,1118,391,499,1780,195109,0.7835671342685371,633.9416376923036
3116,577,27116,43,626,564,1168,521,542,2126,282382,0.9612546125461254,751.8011705231643
3117,340,27116,155,718,552,1041,397,323,1440,128231,1.2291021671826623,511.798788587859
3118,1280,27116,211,625,596,1169,385,544,1858,209440,0.7077205882352942,666.454049428766
3119,955,27116,34,573,549,1161,515,588,2206,302820,0.8758503401360545,781.6450601136042
3120,1187,27116,115,697,566,1157,451,460,1822,207460,0.9804347826086957,644.2057124863144
3121,1719,27116,61,606,498,1165,437,559,1992,244283,0.7817531305903399,709.5421058682846
3122,409,27116,38,649,491,1150,453,501,1908,226953,0.9041916167664672,675.4331943279069
3123,421,27116,231,636,629,1009,398,373,1542,148454,1.0670241286863271,545.4658559433395
3124,930,23435,40,566,176,646,136,80,432,10880,1.7,157.78466338652817
3125,798,23435,40,560,176,654,136,94,460,12784,1.4468085106382982,165.32392446346051
3126,998,23435,44,566,139,641,95,75,340,7125,1.2666666666666666,121.03718436910205
3127,891,19229,28,781,371,1206,343,425,1536,145775,0.8070588235294117,546.1446694787014
3128,944,19229,63,787,349,1176,286,389,1350,111254,0.7352185089974294,482.82191333865535
3129,800,19229,34,792,346,1167,312,375,1374,117000,0.8320000000000001,487.82066376897154
3130,1185,19229,31,784,371,1199,340,415,1510,141100,0.8192771084337349,536.4932432006949
3131,1610,19229,59,799,309,1090,250,291,1082,72750,0.8591065292096219,383.64175997928066
3133,379,19388,48,979,67,1001,19,22,82,418,0.8636363636363636,29.068883707497267
3134,1589,19388,48,979,66,999,18,20,76,360,0.9,26.90724809414742
3135,868,19388,49,967,98,1003,49,36,170,1764,1.3611111111111112,60.802960454241045
3136,380,19388,51,977,92,997,41,20,122,820,2.05,45.617978911828175
3137,482,7305,71,886,487,1160,416,274,1380,113984,1.5182481751824817,498.1284974783113
3138,1340,7305,161,919,383,1121,222,202,848,44844,1.099009900990099,300.1466308323317
3139,1203,7305,94,872,452,1169,358,297,1310,106326,1.2053872053872057,465.1591125625725
3140,195,7305,107,868,450,1166,343,298,1282,102214,1.151006711409396,454.37099379251754
3141,694,7305,94,871,456,1173,362,302,1328,109324,1.1986754966887416,471.4318614603811
3142,306,7305,80,862,442,1168,362,306,1336,110772,1.1830065359477124,474.0042193905029
3143,1389,7305,84,865,448,1173,364,308,1344,112112,1.181818181818182,476.82281824593923
3144,514,10004,45,645,179,743,134,98,464,13132,1.3673469387755102,166.01204775557707
3145,114,10004,65,642,201,766,136,124,520,16864,1.0967741935483872,184.04347312523745
3146,783,10004,59,642,191,750,132,108,480,14256,1.2222222222222223,170.55204484262273
3147,886,10004,34,641,143,764,109,123,464,13407,0.8861788617886179,164.34719346554112
3148,1696,10004,54,640,178,747,124,107,462,13268,1.158878504672897,163.783393541592
3149,1219,10004,43,650,150,818,107,168,550,17976,0.6369047619047619,199.1808223700264
3150,66,10004,38,652,147,764,109,112,442,12208,0.9732142857142856,156.28499608087785
3151,392,10004,89,674,167,793,78,119,394,9282,0.6554621848739496,142.28492541376264
3152,1599,10004,57,647,186,719,129,72,402,9288,1.7916666666666667,147.73286702694156
3153,1411,10004,36,641,183,842,147,201,696,29547,0.7313432835820896,249.0180716333656
3154,1225,27546,82,803,161,888,79,85,328,6715,0.9294117647058824,116.04309544302927
3155,932,27546,86,802,162,895,76,93,338,7068,0.8172043010752689,120.10412149464314
3156,228,27546,83,799,167,894,84,95,358,7980,0.8842105263157894,126.81088281373961
3157,1389,6441,58,288,372,841,314,553,1734,173642,0.5678119349005425,635.9284550953826
3158,1562,6441,38,269,358,842,320,573,1786,183360,0.5584642233856894,656.2994743255551
3159,490,6441,72,270,400,614,328,344,1344,112832,0.9534883720930232,475.31042488041436
3160,55,21080,285,485,775,985,490,500,1980,245000,0.98,700.0714249274855
3161,1689,21080,335,499,524,737,189,238,854,44982,0.7941176470588235,303.9161068452937
3162,556,21080,293,461,718,998,425,537,1924,228225,0.7914338919925512,684.8313661040943
3163,547,21080,212,457,871,972,659,515,2348,339385,1.2796116504854371,836.3647529636816
3164,57,21080,341,503,696,941,355,438,1586,155490,0.8105022831050228,563.7987229499549
3165,1158,21080,288,470,729,952,441,482,1846,212562,0.9149377593360996,653.3031455610787
3166,1508,21356,111,315,896,981,785,666,2902,522810,1.1786786786786787,1029.456652802827
3167,592,21356,111,141,908,991,797,850,3294,677450,0.9376470588235294,1165.2077068059582
3168,761,21356,74,191,892,980,818,789,3214,645402,1.0367553865652726,1136.5056093130381
3169,900,21356,220,266,888,941,668,675,2686,450900,0.9896296296296296,949.6573066111796
3170,1066,21356,154,341,893,933,739,592,2662,437488,1.2483108108108107,946.881724398565
3171,923,2509,83,713,400,999,317,286,1206,90662,1.1083916083916083,426.94847464301824
3172,455,2509,128,750,359,1005,231,255,972,58905,0.9058823529411764,344.0726667435238
3173,1106,2509,123,760,326,960,203,200,806,40600,1.015,284.9719284420836
3174,1042,17194,120,241,538,713,418,472,1780,197296,0.8855932203389829,630.4823550266891
3175,737,17194,167,156,490,730,323,574,1794,185402,0.5627177700348432,658.6387477213893
3176,1261,17194,-4,131,533,784,537,653,2380,350661,0.8223583460949464,845.4454447213019
3177,1531,17194,14,127,580,759,566,632,2396,357712,0.8955696202531646,848.3984912763577
3178,512,17194,30,124,496,575,466,451,1834,210166,1.033259423503326,648.5036622872689
3179,1322,17194,190,154,541,591,351,437,1576,153387,0.8032036613272311,560.5086975239545
3180,389,17194,68,147,613,752,545,605,2300,329725,0.9008264462809916,814.2788220259691
3181,1365,29593,433,810,548,910,115,100,430,11500,1.15,152.3975065412817
3182,1225,29593,304,752,696,1044,392,292,1368,114464,1.3424657534246576,488.80261865092336
3183,1219,29593,395,754,702,1137,307,383,1380,117581,0.8015665796344648,490.854357218106
3184,841,29593,349,714,696,1092,347,378,1450,131166,0.9179894179894179,513.1208434667218
3185,728,29593,328,697,653,1082,325,385,1420,125125,0.8441558441558441,503.8352905464245
3186,1105,29593,279,728,660,1072,381,344,1450,131064,1.1075581395348837,513.3195885605769
3187,1268,26839,53,514,362,949,309,435,1488,134415,0.7103448275862069,533.5784853233871
3188,932,26839,40,503,349,930,309,427,1472,131943,0.7236533957845434,527.0768444923377
3189,119,26839,100,545,307,836,207,291,996,60237,0.711340206185567,357.1134273588715
3190,1225,26839,45,519,357,928,312,409,1442,127608,0.7628361858190709,514.4171459039833
3191,1603,26839,27,506,362,949,335,443,1556,148405,0.7562076749435666,555.4043572029301
3192,931,26839,352,923,359,947,7,24,62,168,0.2916666666666667,25.0
3193,1643,26839,63,530,302,896,239,366,1210,87474,0.6530054644808743,437.12355232817185
3194,452,26839,113,532,266,696,153,164,634,25092,0.9329268292682928,224.28776159211185
3195,1114,26839,32,513,351,920,319,407,1452,129833,0.7837837837837838,517.117008035899
3196,115,26839,38,507,351,951,313,444,1514,138972,0.704954954954955,543.235676295289
3197,921,16818,24,507,95,567,71,60,262,4260,1.1833333333333331,92.9569792968769
3198,1509,16818,30,510,119,562,89,52,282,4628,1.7115384615384617,103.07764064044152
3199,369,16818,33,512,91,553,58,41,198,2378,1.4146341463414631,71.02816342831905
3200,886,10010,67,618,298,817,231,199,860,45969,1.1608040201005023,304.89670381950674
3201,1219,10010,70,618,280,811,210,193,806,40530,1.0880829015544042,285.21746089606785
3202,783,10010,78,617,271,809,193,192,770,37056,1.0052083333333333,272.237029075767
3203,1324,10201,385,363,387,365,2,2,8,4,1.0,2.8284271247461903
3204,66,10201,29,256,390,473,361,217,1156,78337,1.663594470046083,421.2006647668068
3205,392,10201,138,281,349,476,211,195,812,41145,1.082051282051282,287.30819688968154
3206,1600,10201,90,290,311,443,221,153,748,33813,1.4444444444444444,268.79360111431225
3207,782,10201,51,260,371,468,320,208,1056,66560,1.5384615384615383,381.65953414005
3208,283,10201,39,240,400,463,361,223,1168,80503,1.6188340807174888,424.3229901855425
3209,1599,10201,54,279,237,416,183,137,640,25071,1.3357664233576645,228.60008748904713
3210,3,10201,41,270,392,458,351,188,1078,65988,1.8670212765957448,398.1770962775232
3211,514,10201,55,268,376,464,321,196,1034,62916,1.6377551020408163,376.10769734213096
3212,1696,10201,59,269,334,461,275,192,934,52800,1.4322916666666667,335.393798392278
3213,886,10201,25,276,381,453,356,177,1066,63012,2.0112994350282487,397.57389250301634
3214,1411,10201,18,263,388,478,370,215,1170,79550,1.7209302325581397,427.93106921559223
3215,483,30274,194,810,473,1168,279,358,1274,99882,0.7793296089385475,453.8777368411013
3216,147,30274,167,780,518,1219,351,439,1580,154089,0.7995444191343963,562.0693907339199
3217,1508,30274,215,832,504,1197,289,365,1308,105485,0.7917808219178082,465.55987799637546
3218,1097,34332,155,736,337,946,182,210,784,38220,0.8666666666666667,277.8920653779089
3219,1304,34332,177,762,325,946,148,184,664,27232,0.8043478260869565,236.13555429032706
3220,1625,34332,101,751,373,943,272,192,928,52224,1.4166666666666667,332.938432746957
3221,572,5907,26,251,533,578,507,327,1668,165789,1.5504587155963303,603.3058925619739
3222,577,5907,28,252,518,588,490,336,1652,164640,1.4583333333333333,594.1346648698425
3223,632,5907,14,242,539,590,525,348,1746,182700,1.5086206896551724,629.8642710933841
3224,1496,30247,159,764,715,1126,556,362,1836,201272,1.5359116022099448,663.4606243026032
3225,590,30247,208,729,706,1080,498,351,1698,174798,1.4188034188034189,609.2659517813219
3226,491,30247,133,759,706,1102,573,343,1832,196539,1.6705539358600583,667.8158428788583
3227,203,15913,48,708,351,1219,303,511,1628,154833,0.5929549902152642,594.0791193098778
3228,651,15913,45,703,360,961,315,258,1146,81270,1.2209302325581397,407.1719538475115
3229,360,15913,48,719,384,1201,336,482,1636,161952,0.6970954356846473,587.554252814155
3230,909,15913,79,723,401,1140,322,417,1478,134274,0.7721822541966427,526.8519716201126
3231,857,15913,65,710,387,1036,322,326,1296,104972,0.9877300613496932,458.21392383907323
3232,755,15913,48,705,408,1260,360,555,1830,199800,0.6486486486486487,661.5323121359984
3233,1508,15913,49,701,393,1256,344,555,1798,190920,0.6198198198198198,652.963245519991
3234,957,32152,513,102,970,639,457,537,1988,245409,0.8510242085661079,705.136866147275
3235,128,32152,36,63,960,650,924,587,3022,542388,1.5741056218057918,1094.6894536808145
3236,1548,32152,122,105,959,620,837,515,2704,431055,1.6252427184466018,982.7481874824293
3237,465,32152,109,196,925,583,816,387,2406,315792,2.108527131782946,903.1195934094221
3238,1709,32152,141,176,953,587,812,411,2446,333732,1.9756690997566908,910.0906548251114
3239,191,32152,302,176,926,394,624,218,1684,136032,2.8623853211009176,660.9841147864297
3240,952,32152,205,217,931,507,726,290,2032,210540,2.503448275862069,781.7774619416961
3241,182,33690,57,897,511,1171,454,274,1456,124396,1.6569343065693432,530.2754001459996
3242,1380,33690,45,907,503,1169,458,262,1440,119996,1.748091603053435,527.6438192568922
3243,128,33690,43,885,516,1174,473,289,1524,136697,1.6366782006920415,554.3013620766235
3244,415,33690,277,956,383,1014,106,58,328,6148,1.827586206896552,120.83045973594572
3245,191,33690,158,979,412,1084,254,105,718,26670,2.419047619047619,274.84723029348504
3246,1055,33690,97,896,441,1164,344,268,1224,92192,1.2835820895522387,436.07338831898466
3247,1132,33690,177,943,496,1154,319,211,1060,67309,1.5118483412322274,382.4682993399584
3248,410,33690,60,881,402,1156,342,275,1234,94050,1.2436363636363637,438.8496325622251
3249,1191,33690,101,996,431,1117,330,121,902,39930,2.727272727272727,351.48399679075004
3250,183,8376,47,622,812,1205,765,583,2696,445995,1.3121783876500857,961.8284670355728
3251,347,8376,439,690,757,1099,318,409,1454,130062,0.7775061124694377,518.0781794285492
3252,29,8376,241,723,776,1067,535,344,1758,184040,1.555232558139535,636.0510985762072
3253,525,8376,112,647,798,1163,686,516,2404,353976,1.3294573643410852,858.4008387693945
3254,287,8376,261,780,766,1049,505,269,1548,135845,1.8773234200743492,572.1765461813338
3255,1547,8376,439,651,777,1018,338,367,1410,124046,0.9209809264305178,498.9318590749643
3256,421,8376,41,667,813,1172,772,505,2554,389860,1.5287128712871287,922.501490513701
3257,1181,8376,33,643,796,1206,763,563,2652,429569,1.355239786856128,948.2288753249397
3258,1717,8376,51,686,764,1136,713,450,2326,320850,1.5844444444444443,843.1304762609403
3259,71,8376,80,641,798,1135,718,494,2424,354692,1.4534412955465588,871.5273948649004
3260,947,1275,107,572,300,741,193,169,724,32617,1.142011834319527,256.5345980564805
3261,854,1275,101,605,276,744,175,139,628,24325,1.2589928057553956,223.48601745970598
3262,941,1275,137,576,313,755,176,179,710,31504,0.9832402234636872,251.03187048659777
3263,853,1275,122,581,300,742,178,161,678,28658,1.105590062111801,240.01041644062033
3264,952,1275,125,594,280,701,155,107,524,16585,1.4485981308411215,188.3454273402994
3265,468,1275,98,569,308,763,210,194,808,40740,1.0824742268041236,285.8950856520622
3266,338,1275,149,641,239,682,90,41,262,3690,2.1951219512195124,98.89893831583835
3267,421,1275,114,590,289,723,175,133,616,23275,1.3157894736842106,219.80445855350615
3268,235,1275,98,565,327,763,229,198,854,45342,1.1565656565656566,302.72925197278175
3269,1289,10916,30,746,243,879,213,133,692,28329,1.6015037593984962,251.11352014576994
3270,805,10916,46,733,200,887,154,154,616,23716,1.0,217.78888860545663
3271,596,10916,55,742,203,874,148,132,560,19536,1.1212121212121209,198.31288409984865
3272,314,26973,85,1180,319,1316,234,136,740,31824,1.7205882352941178,270.65106687393643
3273,157,26973,203,1207,533,1413,330,206,1072,67980,1.6019417475728157,389.0192797278819
3274,379,26973,222,988,477,1420,255,432,1374,110160,0.5902777777777778,501.64628973012447
3275,917,26973,148,979,486,1432,338,453,1582,153114,0.7461368653421634,565.201733896845
3276,831,26973,91,1009,569,1368,478,359,1674,171602,1.3314763231197773,597.8001338240065
3277,1585,26973,223,1188,519,1432,296,244,1080,72224,1.213114754098361,383.60396244043153
3278,1458,26973,199,1000,530,1390,331,390,1442,129090,0.8487179487179487,511.5281028447997
3279,1026,26973,88,993,527,1461,439,468,1814,205452,0.938034188034188,641.6735930362103
3280,869,26973,96,995,542,1413,446,418,1728,186428,1.0669856459330145,611.2609917212123
3281,1579,26973,142,1030,550,1448,408,418,1652,170544,0.9760765550239234,584.113002765732
3282,842,27969,24,406,422,713,398,307,1410,122186,1.2964169381107489,502.6459986909276
3283,616,27969,42,464,365,700,323,236,1118,76228,1.36864406779661,400.03124877939223
3284,61,27969,58,455,431,722,373,267,1280,99591,1.397003745318352,458.7134181599662
3285,1504,19926,204,931,349,1092,145,161,612,23345,0.9006211180124224,216.6702563805194
3286,296,19926,75,862,459,1149,384,287,1342,110208,1.3379790940766552,479.40066750057827
3287,1290,19926,88,859,526,1199,438,340,1556,148920,1.2882352941176471,554.4763295218291
3288,1618,19926,114,892,479,1179,365,287,1304,104755,1.2717770034843203,464.32100964742057
3289,763,19926,65,876,531,1160,466,284,1500,132344,1.6408450704225352,545.7215407146762
3290,295,19926,67,873,516,1148,449,275,1448,123475,1.6327272727272728,526.522554122803
3291,1068,17604,32,476,362,715,330,239,1138,78870,1.3807531380753135,407.4567461706825
3292,1022,17604,117,481,364,719,247,238,970,58786,1.0378151260504205,343.0058308542291
3293,648,17604,59,480,347,701,288,221,1018,63648,1.3031674208144797,363.02203789852757
3294,1075,17604,221,482,358,713,137,231,736,31647,0.5930735930735931,268.5702887513807
3295,1077,17604,66,497,329,687,263,190,906,49970,1.3842105263157896,324.45184542548066
3296,909,17604,68,502,325,668,257,166,846,42662,1.5481927710843373,305.94934221207274
3297,1295,23294,38,373,690,745,652,372,2048,242544,1.7526881720430108,750.6583776925427
3298,55,23294,137,415,675,774,538,359,1794,193142,1.4986072423398331,646.7804882647589
3299,1622,23294,31,399,720,759,689,360,2098,248040,1.9138888888888892,777.3808590388626
3300,105,2613,199,883,362,969,163,86,498,14018,1.8953488372093024,184.29595763336752
3301,823,2613,178,850,369,1004,191,154,690,29414,1.2402597402597402,245.3507693079441
3302,980,2613,206,856,383,967,177,111,576,19647,1.5945945945945943,208.92582415776178
3303,1097,2613,165,848,394,995,229,147,752,33663,1.5578231292517006,272.12129648375554
3304,1524,2613,212,838,391,1008,179,170,698,30430,1.0529411764705885,246.86230980042296
3305,601,2613,208,861,375,988,167,127,588,21209,1.31496062992126,209.80467106334882
3306,44,27341,89,998,163,1078,74,80,308,5920,0.925,108.97706180660222
3307,962,27341,86,1036,171,1095,85,59,288,5015,1.4406779661016949,103.46980235798269
3308,1206,27341,78,1036,129,1061,51,25,152,1275,2.04,56.79788728465171
3309,364,27341,103,1036,178,1084,75,48,246,3600,1.5625,89.04493247793498
3310,1442,27341,66,1002,175,1083,109,81,380,8829,1.3456790123456788,135.80132547217644
3311,818,27341,93,1039,176,1084,83,45,256,3735,1.8444444444444448,94.41398201537736
3312,1198,27341,101,1017,161,1078,60,61,242,3660,0.9836065573770492,85.56284240252891
3313,1671,27341,88,1020,174,1109,86,89,350,7654,0.9662921348314608,123.76186811776881
3314,1389,13738,18,466,218,674,200,208,816,41600,0.9615384615384616,288.5550207499429
3315,909,13738,198,332,585,649,387,317,1408,122679,1.220820189274448,500.2579334703249
3316,1207,13738,40,302,584,659,544,357,1802,194208,1.5238095238095235,650.6804131061576
3317,1733,13738,212,318,563,654,351,336,1374,117936,1.0446428571428572,485.8981374732774
3318,1241,13738,193,347,442,590,249,243,984,60507,1.0246913580246917,347.92240514229604
3319,1508,13738,26,429,237,668,211,239,900,50429,0.8828451882845189,318.8134250623709
3320,1285,2053,177,928,563,1282,386,354,1480,136644,1.0903954802259888,523.7480310225519
3321,1383,2053,41,958,389,1316,348,358,1412,124584,0.9720670391061452,499.26746339011515
3322,704,2053,46,908,722,1342,676,434,2220,293384,1.5576036866359446,803.3255877911521
3323,1562,2053,217,928,397,1185,180,257,874,46260,0.7003891050583657,313.765836253726
3324,1384,2053,82,915,727,1365,645,450,2190,290250,1.4333333333333331,786.4636037350997
3325,761,2053,218,925,428,1158,210,233,886,48930,0.9012875536480688,313.6702089775183
3326,430,2053,41,850,750,1389,709,539,2496,382151,1.3153988868274582,890.6188859439261
3327,1023,118,47,1269,188,1372,141,103,488,14523,1.3689320388349515,174.61385970191483
3329,1508,118,48,1270,186,1358,138,88,452,12144,1.568181818181818,163.67040050051813
3330,761,26628,32,610,39,617,7,7,28,49,1.0,9.899494936611665
3331,1729,26628,29,609,39,617,10,8,36,80,1.25,12.806248474865697
3332,138,26628,32,611,36,615,4,4,16,16,1.0,5.656854249492381
3333,643,26628,30,611,37,616,7,5,24,35,1.4,8.602325267042627
3334,647,26628,29,608,41,617,12,9,42,108,1.3333333333333333,15.0
3335,1341,26628,30,611,38,615,8,4,24,32,2.0,8.94427190999916
3336,860,26628,31,610,37,615,6,5,22,30,1.2,7.810249675906654
3337,859,26628,31,610,38,616,7,6,26,42,1.1666666666666667,9.219544457292887
3338,858,26628,30,609,38,617,8,8,32,64,1.0,11.313708498984761
3339,388,8520,116,709,120,714,4,5,18,20,0.8,6.4031242374328485
3340,1698,8520,79,672,357,1071,278,399,1354,110922,0.6967418546365914,486.29723420969606
3341,387,8520,52,662,388,1096,336,434,1540,145824,0.7741935483870968,548.8642819495544
3342,1599,12488,82,360,472,861,390,501,1782,195390,0.7784431137724551,634.9023546971613
3343,839,12488,21,336,427,875,406,539,1890,218834,0.7532467532467533,674.801452280595
3344,3,12488,29,325,481,910,452,585,2074,264420,0.7726495726495727,739.2759971756151
3345,379,286,22,62,955,734,933,672,3210,626976,1.3883928571428572,1149.8143328381327
3346,831,286,32,60,978,760,946,700,3292,662200,1.3514285714285714,1176.8245408725975
3347,1243,286,11,40,728,695,717,655,2744,469635,1.0946564885496184,971.1405665504866
3348,304,9014,45,909,91,939,46,30,152,1380,1.5333333333333334,54.91812087098393
3349,905,9014,75,918,82,933,7,15,44,105,0.4666666666666667,16.55294535724685
3350,1384,9014,51,916,71,936,20,20,80,400,1.0,28.284271247461902
3351,135,9014,52,914,87,937,35,23,116,805,1.5217391304347827,41.88078318274385
3352,758,9014,51,914,92,936,41,22,126,902,1.8636363636363635,46.52956049652737
3353,140,9014,51,915,94,936,43,21,128,903,2.0476190476190474,47.853944456021594
3354,806,9014,52,916,66,936,14,20,68,280,0.7,24.413111231467404
3355,809,9014,50,916,66,937,16,21,74,336,0.7619047619047619,26.40075756488817
3356,1671,9014,52,917,87,925,35,8,86,280,4.375,35.90264614203248
3357,440,9014,78,927,81,931,3,4,14,12,0.75,5.0
3358,1651,2757,70,843,460,1163,390,320,1420,124800,1.21875,504.47993022517755
3359,1006,2757,75,780,470,1139,395,359,1508,141805,1.1002785515320337,533.7658662747178
3360,577,2757,95,813,448,1169,353,356,1418,125668,0.9915730337078652,501.3431958249758
3361,903,13,94,603,608,950,514,347,1722,178358,1.4812680115273775,620.1653005449434
3362,1723,13,69,606,561,981,492,375,1734,184500,1.3119999999999998,618.6186224161054
3363,141,13,46,600,621,969,575,369,1888,212175,1.5582655826558265,683.2173885374991
3364,378,35388,31,535,144,626,113,91,408,10283,1.2417582417582418,145.08618128546908
3365,769,35388,32,532,149,626,117,94,422,10998,1.24468085106383,150.08331019803634
3366,713,35388,30,530,149,630,119,100,438,11900,1.19,155.43809056984713
3367,1585,35388,33,537,148,624,115,87,404,10005,1.3218390804597702,144.20124826089406
3368,1684,35388,34,537,140,624,106,87,386,9222,1.2183908045977012,137.13132391981054
3369,1512,35388,39,546,127,626,88,80,336,7040,1.1,118.92854997854805
3370,828,35388,29,530,149,630,120,100,440,12000,1.2,156.20499351813308
3371,1294,35388,45,555,116,623,71,68,278,4828,1.0441176470588236,98.3107318658548
3372,1400,35388,50,536,141,619,91,83,348,7553,1.0963855421686748,123.1665539016173
3373,737,17180,67,687,123,742,56,55,222,3080,1.018181818181818,78.49203781276162
3374,1261,17180,54,689,146,741,92,52,288,4784,1.7692307692307692,105.67875850898325
3375,672,17180,45,692,126,747,81,55,272,4455,1.4727272727272729,97.9081201943945
3376,1322,17180,55,691,134,733,79,42,242,3318,1.880952380952381,89.47066558375433
3377,389,17180,60,679,143,741,83,62,290,5146,1.3387096774193548,103.60019305001319
3378,512,17180,51,663,144,760,93,97,380,9021,0.9587628865979382,134.3800580443393
3379,1531,17180,53,682,146,744,93,62,310,5766,1.5,111.77208953938367
3380,503,17180,63,675,144,749,81,74,310,5994,1.0945945945945943,109.71326264403953
3381,1598,15657,20,253,653,680,633,427,2120,270291,1.4824355971896956,763.5561537961697
3382,732,15657,405,405,492,560,87,155,484,13485,0.5612903225806452,177.74701122663075
3383,1117,15657,30,259,657,619,627,360,1974,225720,1.7416666666666667,723.0
3384,58,15657,172,236,627,634,455,398,1706,181090,1.1432160804020102,604.5072373429452
3385,1107,15657,94,258,581,612,487,354,1682,172398,1.3757062146892656,602.0672719887704
3386,219,15657,287,277,618,577,331,300,1262,99300,1.1033333333333333,446.72250894710913
3387,1174,15657,15,296,618,683,603,387,1980,233361,1.5581395348837208,716.5040125498251
3388,1254,4608,196,284,664,758,468,474,1884,221832,0.9873417721518988,666.1080993352356
3389,1401,4608,196,376,493,612,297,236,1066,70092,1.2584745762711864,379.3481250777444
3390,100,4608,56,292,651,741,595,449,2088,267155,1.3251670378619154,745.4032465719478
3391,1562,6433,58,939,70,951,12,12,48,144,1.0,16.97056274847714
3392,1389,6433,56,940,72,952,16,12,56,192,1.3333333333333333,20.0
3393,1340,6433,59,940,67,949,8,9,34,72,0.8888888888888888,12.041594578792296
3394,306,6433,58,940,71,952,13,12,50,156,1.0833333333333333,17.69180601295413
3395,529,6433,58,939,71,952,13,13,52,169,1.0,18.384776310850235
3396,490,6433,60,940,68,948,8,8,32,64,1.0,11.313708498984761
3397,361,6433,58,940,68,952,10,12,44,120,0.8333333333333334,15.620499351813308
3398,389,17775,126,579,814,963,688,384,2144,264192,1.7916666666666667,787.9086241436884
3399,1701,17775,85,624,780,880,695,256,1902,177920,2.71484375,740.6490396942401
3400,842,17775,548,601,836,858,288,257,1090,74016,1.1206225680933852,385.9961139700761
3401,167,17775,72,572,824,1082,752,510,2524,383520,1.4745098039215687,908.6275364526435
3402,560,17775,472,620,767,889,295,269,1128,79355,1.0966542750929371,399.2317622634752
3403,1217,17775,66,600,836,1195,770,595,2730,458150,1.2941176470588236,973.1007142120491
3404,170,17775,69,572,825,1194,756,622,2756,470232,1.2154340836012862,978.989274711424
3405,457,17775,50,595,830,1197,780,602,2764,469560,1.2956810631229236,985.2938647936462
3406,886,1125,38,612,496,955,458,343,1602,157094,1.3352769679300291,572.2001398112377
3407,1101,1125,45,615,439,968,394,353,1494,139082,1.1161473087818696,529.0037807048263
3408,880,1125,371,886,509,967,138,81,438,11178,1.7037037037037035,160.01562423713506
3409,1225,1125,39,617,501,963,462,346,1616,159852,1.3352601156069364,577.2001386001219
3410,1103,1125,35,615,506,950,471,335,1612,157785,1.405970149253731,577.984428856003
3411,1602,1125,83,618,382,926,299,308,1214,92092,0.9707792207792209,429.26099287030496
3412,924,1125,94,676,426,958,332,282,1228,93624,1.177304964539007,435.600734618297
3413,1270,32714,49,746,168,792,119,46,330,5474,2.5869565217391304,127.58134659894448
3414,453,32714,42,736,94,791,52,55,214,2860,0.9454545454545454,75.69015788066504
3415,1596,32714,49,746,180,832,131,86,434,11266,1.5232558139534884,156.70673246545599
3416,1046,32714,57,752,166,811,109,59,336,6431,1.847457627118644,123.94353553130554
3417,1528,32714,48,741,94,788,46,47,186,2162,0.9787234042553192,65.76473218982953
3418,280,32714,52,742,185,820,133,78,422,10374,1.705128205128205,154.18495387034366
3419,669,32714,43,743,180,827,137,84,442,11508,1.630952380952381,160.70158679988197
3420,884,32714,40,738,136,828,96,90,372,8640,1.0666666666666669,131.59027319676784
3421,934,32714,42,739,184,832,142,93,470,13206,1.5268817204301075,169.7439247808298
3422,670,32714,42,737,180,832,138,95,466,13110,1.4526315789473685,167.53805537847214
3423,21,32988,294,1096,557,1359,263,263,1052,69169,1.0,371.938166904124
3424,1280,32988,292,1072,550,1383,258,311,1138,80238,0.8295819935691319,404.0853870161602
3425,957,32988,198,1011,644,1425,446,414,1720,184644,1.077294685990338,608.5326614077505
3426,128,32988,213,1023,619,1441,406,418,1648,169708,0.971291866028708,582.7177704515283
3427,191,32988,248,1152,582,1312,334,160,988,53440,2.0875,370.3457843691487
3428,1232,32988,177,1043,630,1407,453,364,1634,164892,1.2445054945054943,581.1239110551209
3429,525,32988,324,1101,479,1329,155,228,766,35340,0.6798245614035088,275.6972977742074
3430,1132,32988,246,1124,694,1423,448,299,1494,133952,1.4983277591973243,538.61396194306
3431,1068,17622,440,262,441,264,1,2,6,2,0.5,2.23606797749979
3432,648,17622,62,253,469,521,407,268,1350,109076,1.5186567164179106,487.31201503759377
3433,1077,17622,174,270,468,530,294,260,1108,76440,1.1307692307692307,392.4742029739025
3434,128,33598,150,794,728,1355,578,561,2278,324258,1.0303030303030305,805.484326352785
3435,952,33598,303,871,622,1066,319,195,1028,62205,1.635897435897436,373.8796597837331
3436,191,33598,246,867,615,997,369,130,998,47970,2.8384615384615386,391.2301113155786
3437,957,33598,228,875,696,1244,468,369,1674,172692,1.2682926829268293,595.9739927211589
3438,1191,33598,273,945,581,1093,308,148,912,45584,2.081081081081081,341.7133301467767
3439,1280,33598,305,848,652,1279,347,431,1556,149557,0.8051044083526682,553.3263051762495
3440,1055,33598,269,854,601,1224,332,370,1404,122840,0.8972972972972973,497.1156807021883
3441,525,33598,222,814,376,1137,154,323,954,49742,0.4767801857585139,357.8337602854152
3442,972,4052,208,396,593,781,385,385,1540,148225,1.0,544.4722215136416
3443,1389,4052,190,402,683,770,493,368,1722,181424,1.3396739130434785,615.201592975831
3444,439,4052,207,388,585,694,378,306,1368,115668,1.2352941176470589,486.33321909982664
3445,842,17925,259,569,821,1220,562,651,2426,365862,0.8632872503840245,860.0261623927495
3446,321,17925,304,644,794,988,490,344,1668,168560,1.4244186046511629,598.6952480185557
3447,731,17925,135,627,825,1281,690,654,2688,451260,1.055045871559633,950.69237926892
3448,170,17925,264,622,828,1247,564,625,2378,352500,0.9024,841.8556883456927
3449,116,17925,111,600,792,1276,681,676,2714,460356,1.007396449704142,959.5504155592868
3450,734,17925,66,601,794,1200,728,599,2654,436072,1.2153589315525877,942.753944568783
3451,832,23464,550,516,1031,880,481,364,1690,175084,1.3214285714285714,603.2056034222494
3452,794,23464,604,551,942,919,338,368,1412,124384,0.9184782608695652,499.6678897027505
3453,1364,23464,688,520,983,944,295,424,1438,125080,0.6957547169811321,516.5278308087571
3454,998,23464,173,551,938,1040,765,489,2508,374085,1.5644171779141105,907.9350197013
3455,833,23464,130,631,1012,1083,882,452,2668,398664,1.9513274336283184,991.0741647323878
3456,930,23464,563,526,1001,956,438,430,1736,188340,1.0186046511627906,613.7947539691098
3457,620,23464,97,514,928,1107,831,593,2848,492783,1.4013490725126476,1020.886869344493
3458,220,23464,703,528,940,768,237,240,954,56880,0.9875,337.2966053787082
3459,1700,23464,576,534,969,913,393,379,1544,148947,1.0369393139841692,545.9761899570346
3460,1595,23464,207,786,580,1047,373,261,1268,97353,1.4291187739463602,455.2471856036015
3461,1684,15826,172,221,830,705,658,484,2284,318472,1.359504132231405,816.835356727413
3462,447,15826,189,211,868,713,679,502,2362,340858,1.3525896414342629,844.4199192345003
3463,552,15826,186,225,816,697,630,472,2204,297360,1.3347457627118644,787.2001016260097
3464,1562,4038,23,508,43,522,20,14,68,280,1.4285714285714286,24.413111231467404
3465,972,4038,25,508,43,519,18,11,58,198,1.6363636363636365,21.095023109728988
3466,1389,4038,24,508,41,522,17,14,62,238,1.2142857142857142,22.02271554554524
3467,1024,4038,26,508,43,519,17,11,56,187,1.5454545454545454,20.248456731316587
3468,1186,34990,50,657,235,827,185,170,710,31450,1.088235294117647,251.24689052802225
3469,191,34990,97,670,221,808,124,138,524,17112,0.8985507246376812,185.52627846210896
3470,1332,34990,82,688,206,801,124,113,474,14012,1.0973451327433628,167.7647161950331
3471,912,27645,64,405,611,921,547,516,2126,282252,1.060077519379845,751.9740687018402
3472,54,27645,64,420,624,938,560,518,2156,290080,1.0810810810810811,762.8394326462155
3473,1078,27645,33,428,643,919,610,491,2202,299510,1.2423625254582484,783.0587461997982
3474,555,1095,34,601,41,605,7,4,22,28,1.75,8.06225774829855
3476,831,1095,34,601,42,606,8,5,26,40,1.6,9.433981132056603
3477,1359,1095,33,601,42,606,9,5,28,45,1.8,10.295630140987
3478,1351,1095,35,601,42,606,7,5,24,35,1.4,8.602325267042627
3479,1750,1095,34,601,42,605,8,4,24,32,2.0,8.94427190999916
3480,1243,1095,34,599,42,606,8,7,30,56,1.1428571428571428,10.63014581273465
3481,1400,1095,36,601,38,604,2,3,10,6,0.6666666666666666,3.605551275463989
3482,1692,1095,34,599,42,606,8,7,30,56,1.1428571428571428,10.63014581273465
3483,1441,29645,36,521,53,536,17,15,64,255,1.1333333333333333,22.67156809750927
3484,1453,29645,33,517,53,537,20,20,80,400,1.0,28.284271247461902
3485,1068,29645,36,519,50,535,14,16,60,224,0.875,21.2602916254693
3486,590,29645,34,520,53,535,19,15,68,285,1.2666666666666666,24.20743687382041
3487,252,29645,36,522,49,532,13,10,46,130,1.3,16.401219466856727
3488,491,29645,36,518,50,535,14,17,62,238,0.8235294117647058,22.02271554554524
3489,145,29645,37,522,41,527,4,5,18,20,0.8,6.4031242374328485
3490,147,29645,36,518,52,534,16,16,64,256,1.0,22.627416997969522
3491,1550,21424,41,572,64,589,23,17,80,391,1.3529411764705883,28.600699292150182
3492,120,21424,44,572,62,588,18,16,68,288,1.125,24.08318915758459
3493,1609,21424,40,571,61,589,21,18,78,378,1.1666666666666667,27.65863337187866
3494,1311,27714,182,470,679,876,497,406,1806,201782,1.2241379310344829,641.7515095424396
3495,567,27714,191,497,569,855,378,358,1472,135324,1.0558659217877095,520.6227040765702
3496,1268,27714,107,489,560,849,453,360,1626,163080,1.2583333333333333,578.6268227450228
3497,192,2786,120,862,339,1140,219,278,994,60882,0.7877697841726619,353.89970330589426
3498,412,2786,130,845,357,1097,227,252,958,57204,0.9007936507936508,339.1651515117672
3499,577,2786,90,810,334,1150,244,340,1168,82960,0.7176470588235294,418.4925327888181
3500,1554,2786,35,811,489,1145,454,334,1576,151636,1.3592814371257484,563.6239881339332
3501,404,2786,100,819,426,1126,326,307,1266,100082,1.0618892508143325,447.8001786511479
3502,1491,2786,80,827,367,1129,287,302,1178,86674,0.9503311258278144,416.62093082321246
3503,289,23561,52,794,79,816,27,22,98,594,1.2272727272727273,34.828149534535996
3504,1608,23561,45,787,99,821,54,34,176,1836,1.5882352941176472,63.812224534175265
3505,80,23561,60,793,72,810,12,17,58,204,0.7058823529411765,20.808652046684813
3506,957,23561,49,789,104,823,55,34,178,1870,1.6176470588235294,64.66065264130884
3507,576,23561,43,783,98,821,55,38,186,2090,1.4473684210526316,66.85057965343307
3508,15,23561,42,783,104,821,62,38,200,2356,1.631578947368421,72.71863585079137
3509,952,23561,50,790,101,819,51,29,160,1479,1.7586206896551724,58.66856057549052
3510,1438,23561,47,788,103,821,56,33,178,1848,1.6969696969696968,65.0
3511,1483,23561,51,790,99,819,48,29,154,1392,1.6551724137931034,56.08029957123981
3512,1010,23561,45,794,97,821,52,27,158,1404,1.9259259259259256,58.59180830116101
3513,335,3038,42,573,257,714,215,141,712,30315,1.5248226950354609,257.1108710264893
3514,412,3038,103,611,223,675,120,64,368,7680,1.875,136.0
3515,889,3038,59,575,263,734,204,159,726,32436,1.2830188679245282,258.64454372748713
3516,1235,3038,55,580,271,713,216,133,698,28728,1.6240601503759398,253.6631624812716
3517,1491,3038,71,567,246,741,175,174,698,30450,1.0057471264367817,246.78127967899024
3518,577,3038,50,574,220,730,170,156,652,26520,1.0897435897435896,230.72927859289987
3519,242,3038,48,571,261,735,213,164,754,34932,1.2987804878048779,268.8215021161812
3520,192,3038,73,590,228,686,155,96,502,14880,1.6145833333333333,182.3211452355431
3521,464,3038,106,575,239,591,133,16,298,2128,8.3125,133.9589489358587
3522,1559,20834,72,231,874,864,802,633,2870,507666,1.2669826224328593,1021.7108201443302
3523,1557,20834,58,272,864,818,806,546,2704,440076,1.4761904761904765,973.5255517961508
3524,592,20834,205,280,807,798,602,518,2240,311836,1.162162162162162,794.1838578062387
3525,140,13778,83,1040,340,1230,257,190,894,48830,1.3526315789473684,319.6075718752608
3526,1241,13778,98,1052,307,1237,209,185,788,38665,1.1297297297297295,279.1164631475542
3527,1389,13778,76,1034,341,1243,265,209,948,55385,1.2679425837320577,337.4996296294264
3528,1595,22413,423,916,625,1195,202,279,962,56358,0.7240143369175627,344.4488350974641
3529,110,22413,408,930,412,933,4,3,14,12,1.3333333333333333,5.0
3530,217,22413,331,827,712,1255,381,428,1618,163068,0.8901869158878505,573.013961435496
3531,1222,22413,384,891,693,1262,309,371,1360,114639,0.8328840970350404,482.8270912034659
3532,1470,22413,363,902,681,1180,318,278,1192,88404,1.1438848920863312,422.3837118071671
3533,259,18864,244,436,485,783,241,347,1176,83627,0.6945244956772334,422.48076879308957
3534,1097,18864,153,406,571,797,418,391,1618,163438,1.0690537084398977,572.3678886869877
3535,551,18864,222,440,504,779,282,339,1242,95598,0.831858407079646,440.95918178443685
3536,1033,18864,269,446,427,736,158,290,896,45820,0.5448275862068965,330.2483913662563
3537,1293,18864,293,489,417,740,124,251,750,31124,0.4940239043824701,279.95892555873263
3538,941,30315,136,570,510,839,374,269,1286,100606,1.3903345724907064,460.6918709940517
3539,577,30315,139,604,535,803,396,199,1190,78804,1.9899497487437183,443.1895756896816
3540,744,30315,132,610,465,803,333,193,1052,64269,1.7253886010362691,384.8869964028403
3541,242,25142,54,1476,57,1478,3,2,10,6,1.5,3.605551275463989
3542,941,25142,55,1476,57,1478,2,2,8,4,1.0,2.8284271247461903
3543,1123,25142,54,1476,57,1478,3,2,10,6,1.5,3.605551275463989
3544,291,25142,56,1476,57,1477,1,1,4,1,1.0,1.4142135623730951
3545,77,25142,55,1475,57,1478,2,3,10,6,0.6666666666666666,3.605551275463989
3546,1554,25142,54,1475,58,1478,4,3,14,12,1.3333333333333333,5.0
3547,12,25142,54,1476,57,1478,3,2,10,6,1.5,3.605551275463989
3548,952,25142,55,1476,57,1477,2,1,6,2,2.0,2.23606797749979
3549,189,25142,54,1475,57,1478,3,3,12,9,1.0,4.242640687119285
3550,1212,12016,34,710,47,724,13,14,54,182,0.9285714285714286,19.1049731745428
3551,831,12016,35,711,47,723,12,12,48,144,1.0,16.97056274847714
3552,917,12016,36,710,47,725,11,15,52,165,0.7333333333333333,18.601075237738275
3553,1503,28478,48,887,62,891,14,4,36,56,3.5,14.560219778561036
3554,1508,28478,46,885,64,893,18,8,52,144,2.25,19.697715603592208
3555,1442,28478,48,886,63,892,15,6,42,90,2.5,16.15549442140351
3556,1206,28478,46,883,65,894,19,11,60,209,1.7272727272727273,21.95449840010015
3557,39,28478,47,886,63,893,16,7,46,112,2.2857142857142856,17.46424919657298
3558,698,28478,48,887,62,892,14,5,38,70,2.8,14.866068747318506
3559,1198,28478,47,888,62,892,15,4,38,60,3.75,15.524174696260024
3560,818,28478,43,881,67,893,24,12,72,288,2.0,26.832815729997478
3561,252,28478,47,887,62,891,15,4,38,60,3.75,15.524174696260024
3562,620,24380,196,890,878,1456,682,566,2496,386012,1.2049469964664308,886.2730956087971
3563,832,24380,264,875,812,1493,548,618,2332,338664,0.8867313915857605,825.9709437988723
3564,1595,24380,263,892,733,1387,470,495,1930,232650,0.9494949494949496,682.586990793115
3565,1520,33259,235,1266,329,1343,94,77,342,7238,1.2207792207792207,121.51131634543344
3566,1361,33259,235,1235,397,1397,162,162,648,26244,1.0,229.1025971044414
3567,1304,33259,242,1244,341,1373,99,129,456,12771,0.7674418604651163,162.60996279441184
3568,1084,33259,267,1279,301,1306,34,27,122,918,1.2592592592592593,43.41658669218482
3569,1249,33259,253,1255,319,1349,66,94,320,6204,0.7021276595744681,114.85643212288984
3570,1035,33259,236,1270,283,1357,47,87,268,4089,0.5402298850574713,98.88377015466189
3571,499,33259,250,1272,325,1349,75,77,304,5775,0.9740259740259741,107.48953437428223
3572,1753,33259,252,1273,319,1340,67,67,268,4489,1.0,94.75230867899737
3573,1578,33259,240,1266,340,1352,100,86,372,8600,1.162790697674419,131.89389675038038
3574,1513,33259,109,1192,508,1448,399,256,1310,102144,1.55859375,474.0643416246364
3575,1200,21563,175,658,431,722,256,64,640,16384,4.0,263.8787600395303
3576,89,21563,180,625,470,780,290,155,890,44950,1.870967741935484,328.8236609491476
3577,809,21563,51,529,479,821,428,292,1440,124976,1.4657534246575343,518.1196772947346
3578,966,21563,108,582,485,807,377,225,1204,84825,1.6755555555555557,439.0375838125934
3579,906,21563,64,567,470,796,406,229,1270,92974,1.7729257641921397,466.12981024603005
3580,422,21563,79,544,487,798,408,254,1324,103632,1.6062992125984252,480.6037869180808
3581,1562,21563,98,569,457,794,359,225,1168,80775,1.5955555555555556,423.68148413637334
3582,805,21563,260,533,482,800,222,267,978,59274,0.8314606741573034,347.236230828524
3583,653,21563,125,573,460,800,335,227,1124,76045,1.4757709251101319,404.6652937922895
3584,1659,18093,51,478,569,1184,518,706,2448,365708,0.7337110481586402,875.6483312380605
3585,956,18093,60,511,566,1126,506,615,2242,311190,0.8227642276422764,796.4050476987197
3586,1179,18093,43,486,575,1121,532,635,2334,337820,0.8377952755905512,828.4014727171844
3587,763,19187,20,319,249,463,229,144,746,32976,1.5902777777777777,270.51247660690257
3588,1503,19187,19,316,158,448,139,132,542,18348,1.053030303030303,191.68985366993215
3589,355,19187,17,321,242,466,225,145,740,32625,1.5517241379310345,267.67517628648346
3590,801,17216,62,761,405,1096,343,335,1356,114905,1.0238805970149254,479.4517702543187
3591,521,17216,71,759,406,1048,335,289,1248,96815,1.1591695501730104,442.43191566612825
3592,413,17216,95,777,368,1030,273,253,1052,69069,1.0790513833992097,372.2069316925734
3593,811,14480,88,461,588,1056,500,595,2190,297500,0.8403361344537815,777.1904528492356
3594,1508,14480,38,450,541,1139,503,689,2384,346567,0.7300435413642961,853.070923194549
3595,198,14480,68,547,494,1092,426,545,1942,232170,0.781651376146789,691.7376670385963
3596,434,17007,138,407,554,908,416,501,1834,208416,0.8303393213572854,651.1965909001674
3597,1075,17007,82,516,570,911,488,395,1766,192760,1.2354430379746837,627.8287983200515
3598,651,17007,255,492,421,842,166,350,1032,58100,0.4742857142857143,387.3706235635325
3599,1194,17007,28,420,603,864,575,444,2038,255300,1.2950450450450448,726.4716099064024
3600,813,17007,272,558,540,800,268,242,1020,64856,1.1074380165289257,361.09278585981195
3601,909,17007,70,493,561,828,491,335,1652,164485,1.4656716417910447,594.395491234582
3602,648,17007,16,345,599,911,583,566,2298,329978,1.030035335689046,812.5546135491447
3603,58,16238,393,512,789,1008,396,496,1784,196416,0.7983870967741935,634.6904757438857
3604,1598,16238,186,526,871,1070,685,544,2458,372640,1.2591911764705883,874.7348169588313
3605,1174,16238,273,529,725,1065,452,536,1976,242272,0.8432835820895522,701.1419257183242
3606,1107,16238,236,570,863,1060,627,490,2234,307230,1.2795918367346941,795.7568724177002
3607,1370,16238,513,528,800,1047,287,519,1612,148953,0.5529865125240848,593.068292863478
3608,1117,16238,232,526,862,1008,630,482,2224,303660,1.3070539419087135,793.2364086449891
3609,1107,16237,34,491,429,735,395,244,1278,96380,1.6188524590163935,464.2854725274096
3610,58,16237,74,488,413,677,339,189,1056,64071,1.7936507936507935,388.12626811387037
3611,322,16237,37,497,350,684,313,187,1000,58531,1.6737967914438503,364.6066373504465
3612,515,31556,35,656,205,799,170,143,626,24310,1.1888111888111887,222.1463481581455
3613,726,31556,38,653,237,800,199,147,692,29253,1.3537414965986394,247.40654801358835
3614,453,31556,64,676,219,806,155,130,570,20150,1.1923076923076923,202.2992832414391
3615,398,31556,80,700,173,757,93,57,300,5301,1.631578947368421,109.07795377618706
3616,455,31556,64,677,196,795,132,118,500,15576,1.11864406779661,177.05366418123066
3617,937,31556,60,718,181,729,121,11,264,1331,11.0,121.49897118905987
3618,1528,31556,71,712,164,800,93,88,362,8184,1.056818181818182,128.03515142334936
3619,998,31556,37,663,192,790,155,127,564,19685,1.220472440944882,200.38463014912097
3620,884,31556,35,666,191,802,156,136,584,21216,1.1470588235294117,206.95893312442448
3621,1046,31556,59,689,157,783,98,94,384,9212,1.0425531914893618,135.79396157414365
3622,669,31556,36,657,190,800,154,143,594,22022,1.0769230769230769,210.1547049199708
3623,1596,31556,43,662,206,798,163,136,598,22168,1.1985294117647058,212.2851855405836
3624,1061,11031,68,824,76,846,8,22,60,176,0.3636363636363637,23.40939982143925
3625,893,11031,64,825,82,843,18,18,72,324,1.0,25.45584412271571
3626,685,11031,47,826,84,846,37,20,114,740,1.85,42.05948168962618
3627,516,11031,50,825,82,847,32,22,108,704,1.4545454545454546,38.8329756778952
3628,1653,11031,48,825,84,849,36,24,120,864,1.5,43.266615305567875
3629,1548,11031,50,825,62,844,12,19,62,228,0.631578947368421,22.47220505424423
3630,1234,11031,64,823,82,847,18,24,84,432,0.75,30.0
3631,799,11031,65,822,83,849,18,27,90,486,0.6666666666666666,32.449961479175904
3632,232,11031,48,824,86,849,38,25,126,950,1.52,45.48626166217664
3633,421,11031,51,824,60,841,9,17,52,153,0.5294117647058824,19.235384061671343
3634,337,27121,112,301,809,828,697,527,2448,367319,1.3225806451612905,873.806614760955
3635,340,27121,129,376,719,726,590,350,1880,206500,1.6857142857142855,686.0029154456998
3636,188,27121,102,276,814,871,712,595,2614,423640,1.1966386554621848,927.8841522517776
3637,691,27121,178,429,816,842,638,413,2102,263494,1.5447941888619854,760.0085525834561
3638,744,27121,116,309,489,695,373,386,1518,143978,0.9663212435233159,536.7727638395972
3639,79,27121,278,373,755,748,477,375,1704,178875,1.272,606.7569529885916
3640,1187,27121,163,357,792,779,629,422,2102,265438,1.490521327014218,757.446367738337
3641,409,27121,175,329,815,819,640,490,2260,313600,1.3061224489795915,806.0397012554655
3642,955,27121,49,302,426,742,377,440,1634,165880,0.8568181818181818,579.4212629857485
3643,873,5389,39,452,78,484,39,32,142,1248,1.21875,50.44799302251776
3644,827,5389,37,454,77,473,40,19,118,760,2.1052631578947367,44.28317965096906
3645,546,5389,38,454,77,480,39,26,130,1014,1.5,46.87216658103186
3646,1212,5389,37,454,78,482,41,28,138,1148,1.4642857142857142,49.64876634922564
3647,1745,5389,49,462,73,475,24,13,74,312,1.8461538461538465,27.294688127912362
3648,1097,5389,32,454,66,487,34,33,134,1122,1.0303030303030305,47.38143096192854
3649,313,5389,35,453,76,480,41,27,136,1107,1.5185185185185186,49.09175083453431
3650,1087,5389,39,456,74,482,35,26,122,910,1.3461538461538465,43.60045871318328
3651,1683,5389,42,450,72,483,30,33,126,990,0.9090909090909092,44.598206241955516
3652,1357,5389,35,456,80,479,45,23,136,1035,1.9565217391304348,50.53711507397311
3653,656,32641,233,354,981,930,748,576,2648,430848,1.2986111111111112,944.0762681054958
3654,1513,32641,204,356,1001,939,797,583,2760,464651,1.367066895368782,987.4705058886569
3655,874,32641,213,379,897,857,684,478,2324,326952,1.4309623430962344,834.4698916078398
3656,1571,10412,28,589,975,1302,947,713,3320,675211,1.3281907433380085,1185.4020415032194
3657,1663,10412,44,582,446,1289,402,707,2218,284214,0.5685997171145686,813.2976085050293
3658,140,10412,44,568,960,1184,916,616,3064,564256,1.4870129870129871,1103.862310254318
3659,1289,10412,965,605,969,609,4,4,16,16,1.0,5.656854249492381
3660,255,10412,385,651,389,655,4,4,16,16,1.0,5.656854249492381
3661,1564,10412,91,599,949,1292,858,693,3102,594594,1.238095238095238,1102.9111478265147
3662,731,17736,122,470,713,920,591,450,2082,265950,1.3133333333333332,742.8196281736233
3663,170,17736,144,445,822,925,678,480,2316,325440,1.4125,830.7129468113519
3664,457,17736,40,438,896,1022,856,584,2880,499904,1.4657534246575343,1036.2393545894693
3665,560,17736,137,477,687,901,550,424,1948,233200,1.2971698113207548,694.4609420262597
3666,451,17736,182,513,791,898,609,385,1988,234465,1.5818181818181818,720.4901109661395
3667,389,17736,161,470,661,834,500,364,1728,182000,1.3736263736263736,618.4626100258608
3668,321,17736,187,494,504,801,317,307,1248,97319,1.03257328990228,441.2912870202628
3669,134,25489,43,533,493,841,450,308,1516,138600,1.4610389610389611,545.3109204848184
3670,805,25489,28,564,292,839,264,275,1078,72600,0.96,381.209915925596
3671,1732,25489,34,552,342,847,308,295,1206,90860,1.0440677966101697,426.4844663056323
3672,843,19799,134,1314,240,1450,106,136,484,14416,0.7794117647058824,172.42969581832475
3673,1614,19799,89,1277,289,1543,200,266,932,53200,0.7518796992481203,332.8002403845286
3674,291,19799,134,1310,259,1443,125,133,516,16625,0.9398496240601504,182.5212316416915
3675,1717,19799,139,1340,262,1463,123,123,492,15129,1.0,173.9482681718907
3676,1012,19799,86,1284,319,1510,233,226,918,52658,1.0309734513274336,324.59975354272837
3677,1431,19799,112,1312,317,1498,205,186,782,38130,1.1021505376344083,276.80498550423545
3678,1281,19799,141,1350,266,1437,125,87,424,10875,1.4367816091954022,152.2957648787385
3679,1552,19799,141,1332,273,1440,132,108,480,14256,1.2222222222222223,170.55204484262273
3680,473,19799,106,1295,327,1496,221,201,844,44421,1.099502487562189,298.7339953872006
3681,10,29178,209,801,644,1183,435,382,1634,166170,1.138743455497382,578.9205472256102
3682,999,29178,33,766,678,1196,645,430,2150,277350,1.5,775.1935242247577
3683,744,29178,87,783,649,1190,562,407,1938,228734,1.3808353808353808,693.8969664150435
3684,852,29178,45,793,648,1183,603,390,1986,235170,1.5461538461538462,718.1288185277068
3685,952,29178,273,799,628,1147,355,348,1406,123540,1.0201149425287357,497.1207096872952
3686,615,34495,52,661,360,910,308,249,1114,76692,1.2369477911646587,396.06186385462564
3687,886,34495,39,666,365,911,326,245,1142,79870,1.3306122448979592,407.8001961745482
3688,937,34495,49,657,162,868,113,211,648,23843,0.5355450236966824,239.35329536064467
3689,506,34495,45,652,364,891,319,239,1116,76241,1.334728033472803,398.6000501756115
3690,169,34495,33,651,337,907,304,256,1120,77824,1.1875,397.4317551479751
3691,1704,34495,44,609,358,926,314,317,1262,99538,0.9905362776025236,446.1894216585597
3692,31,26272,41,439,530,856,489,417,1812,203913,1.1726618705035972,642.6585407508408
3693,484,26272,40,411,557,902,517,491,2016,253847,1.0529531568228103,713.0007012619272
3694,1454,26272,55,420,468,838,413,418,1662,172634,0.9880382775119616,587.6163714533488
3695,1468,32387,35,420,181,547,146,127,546,18542,1.1496062992125984,193.5071058126807
3696,107,32387,38,411,157,550,119,139,516,16541,0.8561151079136691,182.98087331740442
3697,656,32387,35,408,172,548,137,140,554,19180,0.9785714285714284,195.88006534611938
3698,1097,32387,26,402,162,542,136,140,552,19040,0.9714285714285714,195.18196638009363
3699,161,32387,29,406,170,546,141,140,562,19740,1.0071428571428571,198.69826370655582
3700,1112,441,23,594,673,760,650,166,1632,107900,3.9156626506024095,670.862131887022
3701,886,441,21,594,659,798,638,204,1684,130152,3.127450980392157,669.8208715768717
3702,60,441,24,597,670,761,646,164,1620,105944,3.9390243902439024,666.4923105332874
3703,339,24291,53,371,218,545,165,174,678,28710,0.9482758620689656,239.7936613007108
3704,957,24291,77,401,148,472,71,71,284,5041,1.0,100.40916292848975
3705,349,24291,67,398,125,455,58,57,230,3306,1.0175438596491229,81.32035415564789
3706,242,24291,62,399,258,541,196,142,676,27832,1.3802816901408448,242.03305559365234
3707,421,24291,82,398,122,472,40,74,228,2960,0.5405405405405406,84.11896337925236
3708,803,24291,63,400,125,480,62,80,284,4960,0.775,101.21264743103995
3709,952,24291,77,400,133,477,56,77,266,4312,0.7272727272727273,95.2102935611481
3710,466,24291,54,388,150,493,96,105,402,10080,0.9142857142857144,142.2708684165525
3711,1602,1614,250,948,801,1442,551,494,2090,272194,1.1153846153846154,740.0249995777169
3712,880,1614,115,987,711,1467,596,480,2152,286080,1.2416666666666667,765.2555128844222
3713,1101,1614,227,879,860,1478,633,599,2464,379167,1.0567612687813022,871.4872345594054
3714,1182,21836,222,400,586,703,364,303,1334,110292,1.2013201320132014,473.60848809961163
3715,853,21836,223,350,545,729,322,379,1402,122038,0.8496042216358839,497.31780583445834
3716,851,21836,205,349,603,697,398,348,1492,138504,1.1436781609195403,528.6851615091916
3717,1698,7876,22,296,584,728,562,432,1988,242784,1.3009259259259258,708.8497725188321
3718,401,7876,81,360,664,713,583,353,1872,205799,1.651558073654391,681.5409011937581
3719,1319,7876,73,324,91,344,18,20,76,360,0.9,26.90724809414742
3720,874,32431,27,439,85,492,58,53,222,3074,1.0943396226415094,78.56844150166147
3721,1684,32431,29,438,73,524,44,86,260,3784,0.5116279069767442,96.60227740586657
3723,100,32431,22,435,88,521,66,86,304,5676,0.7674418604651163,108.40664186294121
3724,1513,32431,22,435,91,526,69,91,320,6279,0.7582417582417582,114.20157617125956
3725,656,32431,22,436,113,520,91,84,350,7644,1.0833333333333333,123.84264209067892
3726,1244,32431,22,434,118,528,96,94,380,9024,1.0212765957446808,134.35773144854747
3727,858,3973,51,938,98,959,47,21,136,987,2.238095238095238,51.478150704935004
3728,812,3973,48,941,98,956,50,15,130,750,3.333333333333333,52.20153254455275
3729,1508,3973,47,941,94,957,47,16,126,752,2.9375,49.64876634922564
3730,506,35738,75,625,118,652,43,27,140,1161,1.5925925925925926,50.774009099144415
3731,886,35738,78,623,113,646,35,23,116,805,1.5217391304347827,41.88078318274385
3732,169,35738,67,618,124,652,57,34,182,1938,1.6764705882352942,66.37017402418047
3733,1698,35738,80,625,113,646,33,21,108,693,1.5714285714285714,39.11521443121589
3734,1704,35738,48,605,158,665,110,60,340,6600,1.8333333333333333,125.29964086141668
3735,1046,35738,72,622,117,651,45,29,148,1305,1.5517241379310345,53.53503525729669
3736,1212,11805,34,529,531,917,497,388,1770,192836,1.2809278350515465,630.5180409790032
3737,831,11805,43,544,594,911,551,367,1836,202217,1.5013623978201636,662.0347422907653
3738,917,11805,54,544,486,928,432,384,1632,165888,1.125,577.9965397820301
3739,132,24527,487,813,694,864,207,51,516,10557,4.0588235294117645,213.19005605327843
3740,803,24527,132,767,714,1182,582,415,1994,241530,1.4024096385542169,714.8069669498193
3741,242,24527,57,704,795,1237,738,533,2542,393354,1.3846153846153846,910.3477357581552
3742,957,24527,54,732,776,1238,722,506,2456,365332,1.4268774703557312,881.6575298833442
3743,189,24527,44,696,860,1238,816,542,2716,442272,1.5055350553505535,979.601959981706
3744,349,24527,374,709,766,1151,392,442,1668,173264,0.8868778280542986,590.7859172322915
3745,952,24527,358,734,771,1209,413,475,1776,196175,0.8694736842105263,629.439433146669
3746,1228,24527,83,716,813,1230,730,514,2488,375220,1.4202334630350195,892.8023297460642
3747,687,24527,224,698,826,1187,602,489,2182,294378,1.2310838445807772,775.5804278087477
3748,372,22164,46,382,130,409,84,27,222,2268,3.111111111111111,88.23264701911646
3749,1682,22164,17,350,144,454,127,104,462,13208,1.2211538461538465,164.14932226482082
3750,1157,22164,50,368,117,452,67,84,302,5628,0.7976190476190477,107.44766167767449
3751,1083,22164,36,372,45,381,9,9,36,81,1.0,12.727922061357855
3752,1163,22164,23,350,132,454,109,104,426,11336,1.0480769230769231,150.65523555456014
3753,55,22164,30,351,131,451,101,100,402,10100,1.01,142.13022197970423
3754,1303,22164,30,351,132,453,102,102,408,10404,1.0,144.2497833620557
3755,1677,22164,75,387,104,428,29,41,140,1189,0.7073170731707317,50.21951811795888
3756,1684,17852,43,952,328,1173,285,221,1012,62985,1.2895927601809956,360.64664146502184
3757,1522,17852,37,946,340,1180,303,234,1074,70902,1.294871794871795,382.8380858796575
3758,1094,17852,39,944,339,1180,300,236,1072,70800,1.2711864406779658,381.70145401871343
3759,52,6162,43,801,560,1177,517,376,1786,194392,1.375,639.2691139105658
3760,1459,6162,124,848,468,1158,344,310,1308,106640,1.1096774193548389,463.07234855905614
3761,1621,6162,123,776,413,1174,290,398,1376,115420,0.7286432160804021,492.44695145771794
3762,916,6162,132,832,477,1149,345,317,1324,109365,1.088328075709779,468.5232118049222
3763,540,6162,45,771,547,1178,502,407,1818,204314,1.2334152334152335,646.2607832756062
3764,903,10,72,570,420,858,348,288,1272,100224,1.2083333333333333,451.7167253932491
3765,1723,10,96,559,402,856,306,297,1206,90882,1.0303030303030305,426.4328786573568
3766,141,10,95,559,427,852,332,293,1250,97276,1.1331058020477816,442.8013098444945
3767,801,17208,50,867,442,1122,392,255,1294,99960,1.5372549019607844,467.64195705689195
3768,1375,17208,115,967,400,1145,285,178,926,50730,1.6011235955056182,336.01934468122516
3769,1721,17208,162,963,301,1080,139,117,512,16263,1.188034188034188,181.6865432551349
3770,417,17208,175,988,211,1014,36,26,124,936,1.3846153846153846,44.40720662234904
3771,413,17208,157,983,220,1043,63,60,246,3780,1.05,87.0
3772,521,17208,146,954,388,1157,242,203,890,49126,1.192118226600985,315.86864358463947
3773,355,18994,47,252,368,508,321,256,1154,82176,1.25390625,410.58129523883576
3774,429,18994,74,273,330,524,256,251,1014,64256,1.0199203187250996,358.52057123685387
3775,805,18994,128,315,224,397,96,82,356,7872,1.170731707317073,126.25371281669304
3776,432,18994,53,285,182,455,129,170,598,21930,0.7588235294117647,213.40337391897066
3777,532,18994,97,282,352,498,255,216,942,55080,1.1805555555555556,334.1870733586205
3778,1503,18994,57,294,322,483,265,189,908,50085,1.402116402116402,325.49347151671105
3779,489,18994,222,412,267,443,45,31,152,1395,1.4516129032258065,54.644304369257
3780,763,18994,54,286,310,532,256,246,1004,62976,1.0406504065040652,355.03802613241305
3781,315,13844,491,1135,796,1302,305,167,944,50935,1.8263473053892216,347.7269043372974
3782,1466,13844,282,1119,801,1423,519,304,1646,157776,1.7072368421052633,601.4790104400984
3783,552,13844,255,1001,845,1399,590,398,1976,234820,1.4824120603015076,711.690944160455
3784,1308,13844,157,997,854,1352,697,355,2104,247435,1.963380281690141,782.1981846054106
3785,496,13844,287,1100,849,1342,562,242,1608,136004,2.322314049586777,611.8888788007182
3786,161,13844,203,1029,854,1490,651,461,2224,300111,1.4121475054229935,797.6979378185705
3787,1677,21053,74,509,84,529,10,20,60,200,0.5,22.360679774997898
3788,1406,21053,40,492,118,574,78,82,320,6396,0.951219512195122,113.17243480636087
3789,55,21053,40,489,122,568,82,79,322,6478,1.0379746835443038,113.86395390991831
3790,1689,21053,48,495,99,553,51,58,218,2958,0.8793103448275862,77.23341245859851
3791,48,21053,35,486,132,570,97,84,362,8148,1.1547619047619049,128.3160161476345
3792,1163,21053,35,487,126,569,91,82,346,7462,1.1097560975609757,122.494897852931
3793,1158,21053,37,491,122,565,85,74,318,6290,1.148648648648649,112.69871339105873
3794,1461,21053,48,487,106,565,58,78,272,4524,0.7435897435897436,97.20082304178294
3795,913,2647,208,1157,290,1209,82,52,268,4264,1.5769230769230769,97.09788875150684
3796,268,2647,186,1150,306,1228,120,78,396,9360,1.5384615384615383,143.12232530251876
3797,550,2647,133,1119,291,1256,158,137,590,21646,1.1532846715328466,209.124364912365
3798,1097,2647,107,1134,396,1214,289,80,738,23120,3.6125,299.8683044271268
3799,1352,2647,132,1141,273,1220,141,79,440,11139,1.7848101265822784,161.62301816263673
3800,1622,2647,95,1125,287,1261,192,136,656,26112,1.4117647058823528,235.28705871764387
3801,96,2647,103,1095,313,1262,210,167,754,35070,1.2574850299401197,268.3076592272386
3802,105,2647,136,1155,280,1222,144,67,422,9648,2.149253731343284,158.8238017426859
3803,1252,2647,130,1148,273,1246,143,98,482,14014,1.4591836734693877,173.35801106380978
3804,379,29237,86,876,597,1043,511,167,1356,85337,3.059880239520958,537.5965029648165
3805,1585,29237,61,843,487,1040,426,197,1246,83922,2.1624365482233503,469.34528867348826
3806,1165,29237,78,801,486,1078,408,277,1370,113016,1.4729241877256318,493.1460229992735
3807,869,29237,57,779,564,1105,507,326,1666,165282,1.5552147239263805,602.7644647787392
3808,914,29237,32,764,573,1136,541,372,1826,201252,1.4543010752688172,656.5554051258736
3809,1026,29237,51,804,624,1126,573,322,1790,184506,1.7795031055900619,657.2769583668668
3810,917,29237,79,830,551,1094,472,264,1472,124608,1.7878787878787878,540.8142009969782
3811,310,29237,54,805,548,1094,494,289,1566,142766,1.7093425605536332,572.3259560774786
3812,831,29237,89,761,585,1131,496,370,1732,183520,1.3405405405405406,618.8020685162583
3813,314,29237,37,754,374,1038,337,284,1242,95708,1.1866197183098592,440.70965498840616
3814,952,23342,29,509,45,521,16,12,56,192,1.3333333333333333,20.0
3815,68,23342,26,508,48,522,22,14,72,308,1.5714285714285714,26.076809620810597
3816,752,23342,25,508,48,526,23,18,82,414,1.2777777777777777,29.206163733020468
3817,472,23342,27,508,48,521,21,13,68,273,1.6153846153846154,24.698178070456937
3818,636,23342,25,508,49,526,24,18,84,432,1.3333333333333333,30.0
3819,957,23342,25,507,48,526,23,19,84,437,1.2105263157894737,29.832867780352597
3820,1378,23342,38,508,44,516,6,8,28,48,0.75,10.0
3821,952,26565,562,880,567,884,5,4,18,20,1.25,6.4031242374328485
3822,10,26565,224,879,894,1397,670,518,2376,347060,1.2934362934362935,846.890783985751
3823,191,26565,147,895,960,1447,813,552,2730,448776,1.4728260869565215,982.6866234970332
3824,852,26565,39,829,995,1482,956,653,3218,624268,1.4640122511485452,1157.732697992071
3825,470,26565,115,842,936,1436,821,594,2830,487674,1.382154882154882,1013.3493968025047
3826,1011,26565,102,798,646,1456,544,658,2404,357952,0.8267477203647416,853.7564055396598
3827,886,1690,129,512,312,734,183,222,810,40626,0.8243243243243243,287.70297183032363
3828,1225,1690,138,528,373,732,235,204,878,47940,1.1519607843137254,311.1928662421425
3829,1099,1690,134,515,316,736,182,221,806,40222,0.8235294117647058,286.29530209208815
3830,1169,1690,108,495,366,738,258,243,1002,62694,1.0617283950617284,354.41924326988794
3831,1101,1690,125,512,341,724,216,212,856,45792,1.018867924528302,302.65491900843114
3832,880,1690,56,531,367,671,311,140,902,43540,2.2214285714285715,341.05864598335575
3833,1470,10878,49,465,114,560,65,95,320,6175,0.6842105263157895,115.10864433221339
3834,780,10878,48,460,114,570,66,110,352,7260,0.6,128.2809416865966
3835,558,10878,67,467,107,528,40,61,202,2440,0.6557377049180327,72.94518489934754
3836,786,10878,56,451,86,479,30,28,116,840,1.0714285714285714,41.036569057366385
3837,1469,10878,59,457,120,573,61,116,354,7076,0.5258620689655172,131.06105447462264
3838,1107,10878,53,456,84,544,31,88,238,2728,0.3522727272727273,93.30058949438637
3839,1599,10878,61,456,99,527,38,71,218,2698,0.5352112676056338,80.52949770115296
3840,3,10878,56,464,115,565,59,101,320,5959,0.5841584158415841,116.9700816448377
3841,1600,10878,55,458,117,585,62,127,378,7874,0.4881889763779528,141.32586458253138
3842,387,10878,50,446,114,563,64,117,362,7488,0.5470085470085471,133.3604139165742
3843,609,10878,32,460,112,568,80,108,376,8640,0.7407407407407407,134.40238093129153
3844,821,10323,97,788,205,894,108,106,428,11448,1.018867924528302,151.32745950421557
3845,261,10323,113,791,151,857,38,66,208,2508,0.5757575757575758,76.15773105863909
3846,547,10323,94,788,188,902,94,114,416,10716,0.8245614035087719,147.75655653811103
3847,1300,10323,111,793,150,828,39,35,148,1365,1.1142857142857143,52.40229002629561
3848,659,10323,111,788,191,889,80,101,362,8080,0.7920792079207921,128.84486796143648
3849,1580,10323,105,793,233,901,128,108,472,13824,1.1851851851851851,167.47537132366656
3850,917,10323,108,786,191,882,83,96,358,7968,0.8645833333333334,126.90547663517127
3851,1210,10323,84,788,229,908,145,120,530,17400,1.2083333333333333,188.2153022471871
3852,1460,10323,129,799,202,885,73,86,318,6278,0.8488372093023255,112.80514172678478
3853,831,10323,98,786,223,898,125,112,474,14000,1.1160714285714286,167.83622970026465
3854,90,6013,48,926,65,936,17,10,54,170,1.7,19.72308292331602
3855,149,6013,49,929,62,934,13,5,36,65,2.6,13.92838827718412
3856,1451,6013,49,929,63,935,14,6,40,84,2.333333333333333,15.231546211727817
3857,809,6013,48,926,65,936,17,10,54,170,1.7,19.72308292331602
3858,969,6013,53,931,56,932,3,1,8,3,3.0,3.1622776601683795
3859,137,6013,48,928,64,934,16,6,44,96,2.6666666666666665,17.08800749063506
3860,884,31561,13,350,337,646,324,296,1240,95904,1.0945945945945943,438.8530505761581
3861,1528,31561,208,371,274,557,66,186,504,12276,0.3548387096774194,197.36261044078233
3862,669,31561,15,394,326,581,311,187,996,58157,1.6631016042780749,362.8911682584739
3863,1596,31561,39,347,375,581,336,234,1140,78624,1.4358974358974361,409.4532940397476
3864,398,31561,121,454,262,605,141,151,584,21291,0.933774834437086,206.59622455408038
3865,515,31561,18,315,308,640,290,325,1230,94250,0.8923076923076924,435.5743334954437
3866,455,31561,103,352,318,594,215,242,914,52030,0.8884297520661157,323.71129112219734
3867,937,31561,39,464,285,588,246,124,740,30504,1.9838709677419355,275.4850268163408
3868,453,31561,143,339,353,632,210,293,1006,61530,0.7167235494880546,360.4843963336
3869,1046,31561,45,392,323,558,278,166,888,46148,1.6746987951807228,323.7900554371613
3870,1138,29012,30,525,35,531,5,6,22,30,0.8333333333333334,7.810249675906654
3871,1348,29012,30,525,36,530,6,5,22,30,1.2,7.810249675906654
3872,589,29012,30,525,36,530,6,5,22,30,1.2,7.810249675906654
3873,1389,14100,290,789,865,1341,575,552,2254,317400,1.0416666666666667,797.075278753519
3874,1207,14100,56,809,818,1332,762,523,2570,398526,1.4569789674952198,924.2148018723785
3875,903,14100,174,794,725,1322,551,528,2158,290928,1.043560606060606,763.1415333999323
3876,1581,34824,87,965,219,1069,132,104,472,13728,1.2692307692307692,168.04761230080004
3877,1351,34824,80,981,144,1060,64,79,286,5056,0.810126582278481,101.67103815738285
3878,161,34824,64,983,147,1070,83,87,340,7221,0.9540229885057472,120.24142381059865
3879,656,34824,90,992,149,1063,59,71,260,4189,0.8309859154929577,92.31467922275417
3880,826,34824,68,945,237,1069,169,124,586,20956,1.3629032258064515,209.6115454835444
3881,100,34824,66,955,236,1062,170,107,554,18190,1.588785046728972,200.8706051168264
3882,525,23181,239,898,301,1018,62,120,364,7440,0.5166666666666667,135.07035203922436
3883,68,23181,149,895,314,1032,165,137,604,22605,1.2043795620437956,214.46211786700232
3884,682,23181,106,895,324,1042,218,147,730,32046,1.4829931972789117,262.9315500277591
3885,752,23181,94,875,318,994,224,119,686,26656,1.8823529411764703,253.64739304790814
3886,27,23181,201,868,308,1035,107,167,548,17869,0.6407185628742516,198.33809518093088
3887,576,23181,136,888,323,1047,187,159,692,29733,1.1761006289308176,245.45875417267155
3888,952,23181,204,912,205,913,1,1,4,1,1.0,1.4142135623730951
3889,636,23181,85,862,312,1038,227,176,806,39952,1.2897727272727273,287.2368360778262
3890,1549,23181,100,862,322,1048,222,186,816,41292,1.1935483870967742,289.6204412675321
3891,1564,10417,123,564,812,1068,689,504,2386,347256,1.3670634920634919,853.6609397178719
3892,1663,10417,213,621,601,1055,388,434,1644,168392,0.8940092165898618,582.1511831131154
3893,140,10417,185,613,592,1076,407,463,1740,188441,0.8790496760259179,616.4560000519097
3894,140,23883,103,407,807,952,704,545,2498,383680,1.2917431192660551,890.3038807059082
3895,805,23883,36,404,836,904,800,500,2600,400000,1.6,943.3981132056604
3896,971,23883,39,391,858,930,819,539,2716,441441,1.5194805194805194,980.4498967310874
3897,251,23883,32,421,838,851,806,430,2472,346580,1.8744186046511628,913.5294193401764
3898,592,23883,25,378,858,994,833,616,2898,513128,1.3522727272727273,1036.0236483787423
3899,58,21299,320,148,814,651,494,503,1994,248482,0.9821073558648112,705.014184254473
3900,1476,21299,297,146,802,552,505,406,1822,205030,1.2438423645320198,647.9668201381919
3901,2,21299,301,238,679,559,378,321,1398,121338,1.1775700934579438,495.9082576444962
3902,0,21299,44,157,748,657,704,500,2408,352000,1.4080000000000001,863.4905905683049
3903,678,21299,230,132,808,540,578,408,1972,235824,1.4166666666666667,707.4941695872836
3904,774,18830,34,541,531,993,497,452,1898,224644,1.0995575221238938,671.7983328350853
3905,1033,18830,47,560,517,879,470,319,1578,149930,1.4733542319749215,568.0325694887574
3906,606,18830,56,547,508,905,452,358,1620,161816,1.2625698324022343,576.6003815468735
3907,1708,17177,40,714,103,761,63,47,220,2961,1.3404255319148937,78.60025445251433
3908,1416,17177,54,717,100,757,46,40,172,1840,1.15,60.959002616512684
3909,503,17177,40,715,101,759,61,44,210,2684,1.3863636363636365,75.21303078589507
3910,514,9481,214,287,629,724,415,437,1704,181355,0.9496567505720824,602.6557889873787
3911,223,9481,154,257,648,761,494,504,1996,248976,0.98015873015873,705.7279929264532
3912,1411,9481,175,263,700,772,525,509,2068,267225,1.031434184675835,731.2359400357726
3913,1696,9481,274,312,596,675,322,363,1370,116886,0.8870523415977961,485.2349946160108
3914,384,9481,232,263,655,702,423,439,1724,185697,0.9635535307517084,609.6310359553555
3915,66,9481,168,315,625,760,457,445,1804,203365,1.0269662921348317,637.8667572463704
3916,392,9481,256,318,619,668,363,350,1426,127050,1.0371428571428571,504.2509295975566
3917,114,9481,307,411,585,662,278,251,1058,69778,1.1075697211155378,374.54639232009697
3918,1219,9481,238,289,629,717,391,428,1638,167348,0.9135514018691588,579.7111349629228
3919,886,9481,201,296,631,757,430,461,1782,198230,0.9327548806941433,630.4133564574913
3920,169,35187,79,817,292,1043,213,226,878,48138,0.9424778761061948,310.55595309058236
3921,615,35187,86,786,335,1041,249,255,1008,63495,0.976470588235294,356.4070706369333
3922,1046,35187,101,869,297,1008,196,139,670,27244,1.4100719424460433,240.28524715429367
3923,984,1024,103,632,249,803,146,171,634,24966,0.8538011695906432,224.84883811129646
3924,1750,1024,109,629,279,817,170,188,716,31960,0.9042553191489362,253.46400138875737
3925,1684,1024,116,638,265,813,149,175,648,26075,0.8514285714285714,229.83907413666634
3926,1585,1024,125,641,258,778,133,137,540,18221,0.9708029197080292,190.93978108293726
3927,1694,1024,104,635,250,798,146,163,618,23798,0.8957055214723927,218.82641522448793
3928,555,1024,111,633,246,802,135,169,608,22815,0.7988165680473372,216.3007165961315
3929,604,1024,107,625,270,821,163,196,718,31948,0.8316326530612245,254.9215565620138
3930,1737,1024,40,624,267,831,227,207,868,46989,1.0966183574879227,307.21002587806277
3931,1557,20486,191,714,508,960,317,246,1126,77982,1.2886178861788615,401.2542834662329
3932,592,20486,112,651,558,1004,446,353,1598,157438,1.2634560906515582,568.792580823625
3933,481,20486,138,711,479,957,341,246,1174,83886,1.386178861788618,420.47235343123333
3934,136,20486,94,677,566,1004,472,327,1598,154344,1.443425076452599,574.2064088809876
3935,1508,20486,94,754,365,1010,271,256,1054,69376,1.05859375,372.7961909676653
3936,761,20486,437,727,440,730,3,3,12,9,1.0,4.242640687119285
3937,593,20486,140,693,540,1003,400,310,1420,124000,1.2903225806451613,506.06323715519983
3938,884,32798,45,913,273,1090,228,177,810,40356,1.2881355932203389,288.63991407980984
3939,1046,32798,62,939,248,1050,186,111,594,20646,1.6756756756756757,216.60332407421637
3940,1596,32798,40,919,255,1073,215,154,738,33110,1.3961038961038958,264.46360808247323
3941,222,32798,47,933,246,1085,199,152,702,30248,1.3092105263157894,250.4096643502403
3942,453,32798,145,922,265,1058,120,136,512,16320,0.8823529411764706,181.37254478007415
3943,934,32798,46,932,281,1104,235,172,814,40420,1.3662790697674418,291.2198482246703
3944,58,32798,52,932,270,1065,218,133,702,28994,1.6390977443609025,255.36836139193124
3945,1270,32798,201,959,258,1027,57,68,250,3876,0.8382352941176471,88.72992730753249
3946,455,32798,150,929,252,1074,102,145,494,14790,0.7034482758620689,177.28226081590904
3947,280,32798,42,949,279,1047,237,98,670,23226,2.4183673469387754,256.46247288833507
3948,1222,33804,49,512,274,698,225,186,822,41850,1.2096774193548387,291.92636057745796
3949,929,33804,45,534,310,723,265,189,908,50085,1.402116402116402,325.49347151671105
3950,1271,33804,32,512,309,711,277,199,952,55123,1.3919597989949748,341.07183993991646
3951,509,33804,169,533,310,715,141,182,646,25662,0.7747252747252747,230.2281477143922
3952,1411,33804,26,519,309,721,283,202,970,57166,1.400990099009901,347.6967069156681
3953,925,33804,34,513,305,720,271,207,956,56097,1.3091787439613527,341.0131962256006
3954,592,20438,78,585,890,1115,812,530,2684,430360,1.532075471698113,969.6617967105851
3955,865,20438,101,629,876,1043,775,414,2378,320850,1.8719806763285023,878.6472557289416
3956,426,20438,85,645,744,1086,659,441,2200,290619,1.4943310657596371,792.945143121515
3957,370,16852,46,710,100,747,54,37,182,1998,1.4594594594594594,65.45991139621256
3958,1260,16852,40,708,101,744,61,36,194,2196,1.6944444444444444,70.83078426785913
3959,1522,16852,45,708,98,746,53,38,182,2014,1.3947368421052628,65.21502894272147
3960,264,16852,46,706,100,749,54,43,194,2322,1.255813953488372,69.02897942168927
3961,369,16852,46,711,75,739,29,28,114,812,1.0357142857142858,40.311288741492746
3962,1521,16852,42,707,103,747,61,40,202,2440,1.525,72.94518489934754
3964,1509,16852,48,710,80,746,32,36,136,1152,0.8888888888888888,48.16637831516918
3965,375,24662,58,1509,86,1551,28,42,140,1176,0.6666666666666666,50.47771785649585
3966,657,24662,62,1512,86,1552,24,40,128,960,0.6,46.647615158762406
3967,103,24662,63,1515,84,1541,21,26,94,546,0.8076923076923077,33.421549934136806
3968,1746,24662,61,1509,87,1553,26,44,140,1144,0.5909090909090909,51.10772935672255
3969,1152,24662,64,1516,82,1544,18,28,92,504,0.6428571428571429,33.28663395418648
3970,1030,24662,59,1510,86,1546,27,36,126,972,0.75,45.0
3971,666,24662,60,1508,83,1547,23,39,124,897,0.5897435897435898,45.27692569068709
3972,706,24662,65,1521,82,1537,17,16,66,272,1.0625,23.345235059857504
3973,1090,24662,60,1512,84,1542,24,30,108,720,0.8,38.41874542459709
3974,226,2969,282,388,731,679,449,291,1480,130659,1.5429553264604812,535.0532683761496
3975,1045,2969,239,302,688,692,449,390,1678,175110,1.1512820512820512,594.7276687694965
3976,1116,2969,266,246,713,897,447,651,2196,290997,0.6866359447004609,789.6898125213469
3977,1601,2969,395,379,604,651,209,272,962,56848,0.7683823529411765,343.02332282222443
3978,1326,2969,355,227,730,786,375,559,1868,209625,0.6708407871198568,673.1314878981669
3979,391,2969,322,242,679,673,357,431,1576,153867,0.8283062645011601,559.6516773851392
3980,1265,2969,310,281,624,840,314,559,1746,175526,0.5617173524150268,641.1528678872146
3981,787,2969,346,285,677,704,331,419,1500,138689,0.7899761336515513,533.9681638449993
3982,1262,2969,264,220,718,895,454,675,2258,306450,0.6725925925925926,813.4746461937212
3983,248,11938,41,603,76,630,35,27,124,945,1.2962962962962965,44.204072210600685
3984,1135,11938,48,604,71,626,23,22,90,506,1.0454545454545454,31.827660925679098
3985,199,11938,52,609,69,630,17,21,76,357,0.8095238095238095,27.018512172212592
3986,1665,11938,52,610,66,619,14,9,46,126,1.5555555555555556,16.64331697709324
3987,864,11938,43,607,50,627,7,20,54,140,0.35,21.18962010041709
3988,1565,11938,41,606,75,628,34,22,112,748,1.5454545454545454,40.496913462633174
3989,1663,11938,43,605,74,630,31,25,112,775,1.24,39.824615503479755
3990,963,11938,53,609,66,628,13,19,64,247,0.6842105263157895,23.021728866442675
3991,135,11938,44,606,74,631,30,25,110,750,1.2,39.05124837953327
3992,909,11938,46,604,73,630,27,26,106,702,1.0384615384615383,37.48332962798263
3993,404,3009,53,1077,129,1117,76,40,232,3040,1.9,85.88364221433555
3994,520,3009,53,1076,128,1116,75,40,230,3000,1.875,85.0
3995,577,3009,53,1078,197,1177,144,99,486,14256,1.4545454545454546,174.7483905505284
3996,1437,3009,53,1076,196,1175,143,99,484,14157,1.4444444444444444,173.92527130926086
3997,192,3009,63,1076,135,1157,72,81,306,5832,0.8888888888888888,108.37435120913067
3998,1396,5519,61,1236,444,1509,383,273,1312,104559,1.4029304029304028,470.33817620941636
3999,827,5519,59,1230,342,1489,283,259,1084,73297,1.0926640926640927,383.6274234201721
4000,1357,5519,51,1233,478,1528,427,295,1444,125965,1.447457627118644,518.9932562182287
4001,1683,5519,49,1236,323,1531,274,295,1138,80830,0.928813559322034,402.61768465878396
4002,1087,5519,47,1220,482,1528,435,308,1486,133980,1.4123376623376624,533.0
4003,546,5519,43,1227,490,1534,447,307,1508,137229,1.4560260586319218,542.2711498872128
4004,873,5519,44,1224,488,1534,444,310,1508,137640,1.4322580645161291,541.5126960653831
4005,313,5519,46,1237,493,1534,447,297,1488,132759,1.5050505050505047,536.6730848477497
4006,1750,576,210,490,478,813,268,323,1182,86564,0.8297213622291022,419.7058493754882
4007,1243,576,197,476,518,824,321,348,1338,111708,0.9224137931034484,473.4395420748039
4008,555,576,230,505,502,763,272,258,1060,70176,1.054263565891473,374.89731927555846
4009,1694,576,187,477,515,824,328,347,1350,113816,0.9452449567723344,477.48612545287637
4010,1400,576,278,497,486,741,208,244,904,50752,0.8524590163934426,320.62439083762797
4011,1698,7862,24,258,823,742,799,484,2566,386716,1.6508264462809918,934.1611210064353
4012,1047,7862,38,262,770,773,732,511,2486,374052,1.4324853228962815,892.7177605492119
4013,387,7862,89,251,817,759,728,508,2472,369824,1.4330708661417322,887.7206767897209
4014,797,7862,44,296,229,300,185,4,378,740,46.25,185.04323819042943
4015,178,7862,37,251,823,758,786,507,2586,398502,1.5502958579881656,935.3314920390525
4016,401,7862,101,364,674,654,573,290,1726,166170,1.9758620689655173,642.206353129584
4017,1748,5312,51,819,91,853,40,34,148,1360,1.1764705882352942,52.49761899362675
4018,1745,5312,58,822,76,855,18,33,102,594,0.5454545454545454,37.589892258425
4019,873,5312,54,817,92,855,38,38,152,1444,1.0,53.74011537017761
4020,546,5312,54,819,92,855,38,36,148,1368,1.0555555555555556,52.3450093132096
4021,1357,5312,54,820,89,856,35,36,142,1260,0.9722222222222222,50.20956084253277
4022,1683,5312,55,821,88,849,33,28,122,924,1.1785714285714286,43.278170016764804
4023,1396,5312,57,822,84,845,27,23,100,621,1.173913043478261,35.4682957019364
4024,1097,5312,51,817,90,854,39,37,152,1443,1.054054054054054,53.75872022286245
4025,1087,5312,56,818,91,855,35,37,144,1295,0.945945945945946,50.93132631298737
4026,827,5312,55,817,82,850,27,33,120,891,0.8181818181818182,42.638011210655684
4027,313,5312,48,820,91,855,43,35,156,1505,1.2285714285714286,55.44366510251645
4028,1659,18096,201,546,700,1023,499,477,1952,238023,1.0461215932914043,690.3115238788934
4029,890,18096,239,564,623,1060,384,496,1760,190464,0.7741935483870968,627.2734650852051
4030,956,18096,153,581,692,1061,539,480,2038,258720,1.1229166666666666,721.7485711797426
4031,396,30510,104,743,436,1109,332,366,1396,121512,0.907103825136612,494.1457274934187
4032,63,30510,182,791,417,1069,235,278,1026,65330,0.8453237410071942,364.01785670486004
4033,1046,30510,216,817,386,1051,170,234,808,39780,0.7264957264957265,289.2334697091607
4034,1477,30510,173,797,448,1131,275,334,1218,91850,0.8233532934131736,432.64419561575073
4035,886,30510,137,760,440,1089,303,329,1264,99687,0.9209726443768996,447.2694937059759
4036,1698,30510,152,798,417,1073,265,275,1080,72875,0.9636363636363636,381.9031290785662
4037,118,30510,103,738,471,1146,368,408,1552,150144,0.9019607843137256,549.4433546781688
4038,501,23489,137,222,960,809,823,587,2820,483101,1.4020442930153325,1010.889707139211
4039,930,23489,36,208,899,768,863,560,2846,483280,1.5410714285714286,1028.7706255526546
4040,998,23489,94,263,773,699,679,436,2230,296044,1.5573394495412844,806.9306042033602
4041,634,24558,36,617,75,658,39,41,160,1599,0.951219512195122,56.586217403180434
4042,421,24558,43,615,79,666,36,51,174,1836,0.7058823529411765,62.42595614005443
4043,952,24558,43,620,75,661,32,41,146,1312,0.7804878048780488,52.009614495783374
4044,23,24558,39,627,78,661,39,34,146,1326,1.1470588235294117,51.73973328110612
4045,957,24558,35,621,77,666,42,45,174,1890,0.9333333333333332,61.554853586049575
4046,1322,13954,107,430,690,1114,583,684,2534,398772,0.8523391812865497,898.7463490885513
4047,1046,13954,101,416,747,1104,646,688,2668,444448,0.938953488372093,943.7478476796649
4048,1037,13954,111,393,706,1133,595,740,2670,440300,0.8040540540540541,949.5393620066521
4049,1142,31182,100,391,552,766,452,375,1654,169500,1.2053333333333334,587.3065638999789
4050,649,31182,28,372,539,803,511,431,1884,220241,1.185614849187935,668.4923335386876
4051,813,31182,74,377,551,779,477,402,1758,191754,1.1865671641791045,623.805258073383
4052,1508,31182,87,375,567,793,480,418,1796,200640,1.1483253588516746,636.4935192128825
4053,909,31182,96,350,406,688,310,338,1296,104780,0.9171597633136096,458.63275068403044
4054,492,31182,159,382,498,714,339,332,1342,112548,1.0210843373493976,474.4944678286566
4055,207,31182,115,377,495,768,380,391,1542,148580,0.9718670076726342,545.2348118013009
4056,433,31182,62,360,542,776,480,416,1792,199680,1.1538461538461535,635.1818637209346
4057,1193,31182,110,340,554,805,444,465,1818,206460,0.9548387096774194,642.9315671204829
4058,535,31182,53,337,528,664,475,327,1604,155325,1.4525993883792052,576.6749517709261
4059,903,31182,54,346,574,796,520,450,1940,234000,1.1555555555555554,687.6772498781678
4060,1712,34998,89,557,103,590,14,33,94,462,0.42424242424242425,35.84689665786984
4061,525,34998,92,552,118,609,26,57,166,1482,0.456140350877193,62.64982043070834
4062,1377,34998,91,553,118,596,27,43,140,1161,0.627906976744186,50.774009099144415
4063,338,34998,93,558,108,573,15,15,60,225,1.0,21.213203435596427
4064,191,34998,89,555,117,594,28,39,134,1092,0.7179487179487181,48.010415536631214
4065,1186,34998,59,536,132,622,73,86,318,6278,0.8488372093023255,112.80514172678478
4066,1420,34998,84,548,127,613,43,65,216,2795,0.6615384615384615,77.93587107359485
4067,130,34998,91,546,117,611,26,65,182,1690,0.4,70.00714249274856
4068,1332,34998,83,548,125,609,42,61,206,2562,0.6885245901639344,74.06078584514209
4069,886,9890,236,1032,560,1258,324,226,1100,73224,1.4336283185840708,395.03417573673295
4070,783,9890,225,1026,505,1257,280,231,1022,64680,1.2121212121212122,362.98898054899684
4071,514,9890,190,996,557,1284,367,288,1310,105696,1.2743055555555556,466.5115218298472
4072,1219,9890,246,1020,571,1324,325,304,1258,98800,1.069078947368421,445.01797716496804
4073,66,9890,229,1019,578,1311,349,292,1282,101908,1.1952054794520548,455.04395392093716
4074,596,10637,44,332,306,504,262,172,868,45064,1.5232558139534884,313.41346493091197
4075,1289,10637,24,293,348,544,324,251,1150,81324,1.290836653386454,409.84997255093236
4076,1663,10637,23,284,370,530,347,246,1186,85362,1.4105691056910568,425.3527947480773
4077,1239,10637,32,291,359,542,327,251,1156,82077,1.3027888446215143,412.22566635278787
4078,805,10637,18,284,350,537,332,253,1170,83996,1.3122529644268774,417.41226623088113
4079,1638,12780,49,971,289,1112,240,141,762,33840,1.702127659574468,278.3540910423269
4080,1102,12780,71,935,162,964,91,29,240,2639,3.1379310344827585,95.50916186418976
4081,1635,12780,36,938,281,1115,245,177,844,43365,1.3841807909604522,302.2482423439382
4082,781,12780,62,987,280,1108,218,121,678,26378,1.8016528925619837,249.3290997858052
4083,1320,12780,34,1031,307,1060,273,29,604,7917,9.413793103448276,274.5359721420856
4084,3,12780,33,950,305,1111,272,161,866,43792,1.6894409937888202,316.07752213657966
4085,934,12780,51,955,291,1135,240,180,840,43200,1.3333333333333333,300.0
4086,1074,18453,51,303,512,725,461,422,1766,194542,1.0924170616113744,624.9839997951948
4087,1567,18453,22,276,532,728,510,452,1924,230520,1.1283185840707963,681.4719363260676
4088,1240,18453,63,358,243,608,180,250,860,45000,0.72,308.05843601498725
4089,699,18453,90,336,254,452,164,116,560,19024,1.4137931034482758,200.8780724718355
4090,1063,18453,27,325,496,672,469,347,1632,162743,1.351585014409222,583.4123755972271
4091,273,27795,34,924,312,1294,278,370,1296,102860,0.7513513513513513,462.8001728608147
4092,1225,27795,48,948,302,1269,254,321,1150,81534,0.7912772585669782,409.3372692536071
4093,1603,27795,37,950,318,1294,281,344,1250,96664,0.8168604651162791,444.181269303423
4094,1663,19545,27,434,578,789,551,355,1812,195605,1.5521126760563382,655.4586180682958
4095,1558,19545,29,429,564,735,535,306,1682,163710,1.7483660130718954,616.3286460971939
4096,756,19545,29,427,587,797,558,370,1856,206460,1.508108108108108,669.5252049026982
4097,651,15792,150,619,489,864,339,245,1168,83055,1.3836734693877548,418.2654659423845
4098,755,15792,175,552,502,938,327,386,1426,126222,0.8471502590673575,505.8903043150758
4099,203,15792,132,602,493,942,361,340,1402,122740,1.061764705882353,495.9042246240699
4100,961,15792,32,509,613,971,581,462,2086,268422,1.2575757575757576,742.297110327125
4101,1452,15792,128,502,476,987,348,485,1666,168780,0.7175257731958763,596.9329945647166
4102,965,15792,128,587,468,972,340,385,1450,130900,0.8831168831168831,513.638978271704
4103,857,15792,165,589,506,918,341,329,1340,112189,1.0364741641337385,473.83752489645644
4104,88,15792,224,647,535,935,311,288,1198,89568,1.0798611111111112,423.869083562366
4105,969,5286,61,711,93,731,32,20,104,640,1.6,37.73592452822641
4106,137,5286,43,702,114,752,71,50,242,3550,1.42,86.83893136145792
4107,1021,5286,45,702,119,761,74,59,266,4366,1.2542372881355932,94.64142856064674
4108,1508,5286,43,701,71,742,28,41,138,1148,0.6829268292682927,49.64876634922564
4109,1574,5286,46,705,118,750,72,45,234,3240,1.6,84.90583018850944
4110,1065,5286,65,721,90,730,25,9,68,225,2.7777777777777777,26.570660511172846
4111,819,5286,44,702,120,756,76,54,260,4104,1.4074074074074074,93.23089616645332
4112,967,5286,47,704,117,751,70,47,234,3290,1.4893617021276595,84.31488599292535
4113,1137,5286,48,701,121,758,73,57,260,4161,1.2807017543859651,92.61749294814668
4114,687,24544,112,744,461,1149,349,405,1508,141345,0.8617283950617284,534.6269727576415
4115,349,24544,84,777,511,1079,427,302,1458,128954,1.413907284768212,523.0038240777977
4116,132,24544,147,839,270,1077,123,238,722,29274,0.5168067226890757,267.904833849634
4117,242,24544,53,753,563,1145,510,392,1804,199920,1.3010204081632653,643.2448989304152
4118,339,24544,63,730,504,1123,441,393,1668,173313,1.1221374045801529,590.7029710438234
4119,803,24544,109,759,408,1106,299,347,1292,103753,0.8616714697406339,458.0502155877672
4120,952,24544,101,773,511,1119,410,346,1512,141860,1.184971098265896,536.4848553314437
4121,1228,24544,88,734,554,1145,466,411,1754,191526,1.1338199513381997,621.3509475328738
4122,957,24544,98,758,460,1114,362,356,1436,128872,1.0168539325842696,507.7203954934251
4123,978,15887,35,600,691,1078,656,478,2268,313568,1.3723849372384938,811.6772757691323
4124,1577,15887,293,594,679,959,386,365,1502,140890,1.0575342465753426,531.2447646800861
4125,552,15887,284,608,655,1072,371,464,1670,172144,0.7995689655172413,594.0850107518283
4126,1584,15887,171,595,687,1076,516,481,1994,248196,1.0727650727650728,705.4197332085345
4127,447,15887,287,590,645,1029,358,439,1594,157162,0.8154897494305239,566.467121729055
4128,1684,15887,266,606,641,1039,375,433,1616,162375,0.8660508083140878,572.8123602018378
4129,548,15887,291,615,679,977,388,362,1500,140456,1.0718232044198894,530.6486596609851
4130,831,27603,88,652,277,822,189,170,718,32130,1.111764705882353,254.20660888340413
4131,1398,27603,189,711,285,820,96,109,410,10464,0.8807339449541285,145.24806367039804
4132,1078,27603,73,644,265,868,192,224,832,43008,0.8571428571428571,295.0254226333724
4133,1305,27603,60,641,293,892,233,251,968,58483,0.9282868525896414,342.47627655065395
4134,538,27603,60,651,284,868,224,217,882,48608,1.032258064516129,311.8733717392365
4135,768,27603,63,630,293,882,230,252,964,57960,0.9126984126984128,341.18030423809637
4136,866,9209,47,555,188,646,141,91,464,12831,1.5494505494505495,167.8153747426022
4137,261,9209,31,555,185,663,154,108,524,16632,1.4259259259259258,188.09572031282372
4138,1455,9209,50,596,142,658,92,62,308,5704,1.4838709677419355,110.9414259868693
4139,448,9209,62,595,172,664,110,69,358,7590,1.5942028985507246,129.84991336154215
4140,311,9209,44,571,158,673,114,102,432,11628,1.1176470588235294,152.97058540778355
4141,1210,9209,31,558,196,677,165,119,568,19635,1.3865546218487397,203.43549346168678
4142,161,9209,43,558,199,673,156,115,542,17940,1.3565217391304347,193.80660463462024
4143,343,8324,172,672,699,1254,527,582,2218,306714,0.9054982817869416,785.1452094994912
4144,1373,8324,132,636,774,1263,642,627,2538,402534,1.0239234449760766,897.3811899076111
4145,25,8324,386,686,639,1040,253,354,1214,89562,0.7146892655367232,435.1149273467873
4146,748,8324,33,667,788,1187,755,520,2550,392600,1.4519230769230769,916.7469661798723
4147,421,8324,135,658,730,1234,595,576,2342,342720,1.0329861111111112,828.1310282799456
4148,1661,8324,195,674,794,1179,599,505,2208,302495,1.186138613861386,783.4704844472445
4149,1663,30437,188,781,430,1082,242,301,1086,72842,0.8039867109634552,386.21884987659524
4150,140,30437,107,828,410,1085,303,257,1120,77871,1.178988326848249,397.31347825111595
4151,40,30437,116,799,456,1167,340,368,1416,125120,0.9239130434782608,501.02295356600183
4152,809,5670,46,328,939,953,893,625,3036,558125,1.4288,1089.9880733292453
4153,137,5670,28,279,868,886,840,607,2894,509880,1.3838550247116972,1036.3633532694987
4154,865,5670,102,298,849,943,747,645,2784,481815,1.158139534883721,986.9316085727521
4155,1508,5670,14,307,307,878,293,571,1728,167303,0.5131348511383538,641.78656888408
4156,1065,5670,71,363,511,756,440,393,1666,172920,1.1195928753180662,589.956778077852
4157,819,5670,29,296,897,952,868,656,3048,569408,1.3231707317073171,1088.0073529163303
4158,149,5670,72,281,690,910,618,629,2494,388722,0.9825119236883942,881.7964617756186
4159,967,5670,151,517,870,898,719,381,2200,273939,1.8871391076115485,813.7087931195041
4160,595,5670,195,537,750,811,555,274,1658,152070,2.0255474452554743,618.9515328359726
4161,17,22254,51,1333,73,1363,22,30,104,660,0.7333333333333333,37.20215047547655
4162,1182,22254,50,1339,72,1364,22,25,94,550,0.88,33.301651610693426
4163,853,22254,50,1339,72,1364,22,25,94,550,0.88,33.301651610693426
4170,909,31098,99,710,386,1116,287,406,1386,116522,0.7068965517241379,497.19714399823334
4171,1671,31098,80,703,397,1137,317,434,1502,137578,0.7304147465437788,537.4430202356339
4172,1727,31098,97,701,363,1137,266,436,1404,115976,0.6100917431192661,510.7367227838625
4173,182,3811,77,1105,607,1588,530,483,2026,255990,1.0973084886128364,717.06973161611
4174,1004,3811,77,1111,613,1576,536,465,2002,249240,1.1526881720430109,709.5921363713102
4175,1537,3811,212,1252,584,1563,372,311,1366,115692,1.1961414790996785,484.87627287793737
4176,335,3811,252,1199,608,1588,356,389,1490,138484,0.9151670951156812,527.3111036191065
4177,348,3811,74,1099,609,1529,535,430,1930,230050,1.244186046511628,686.3854602189647
4178,1495,3811,57,1073,606,1602,549,529,2156,290421,1.0378071833648392,762.3922874741061
4179,577,3811,86,1113,595,1567,509,454,1926,231086,1.1211453744493391,682.053516961829
4180,129,3811,77,1098,625,1602,548,504,2104,276192,1.0873015873015872,744.5266952903704
4181,421,3811,114,1239,609,1592,495,353,1696,174735,1.4022662889518414,607.9753284468046
4182,1711,3811,150,1141,597,1597,447,456,1806,203832,0.9802631578947368,638.5491367154136
4183,810,11910,139,772,300,918,161,146,614,23506,1.1027397260273972,217.3407462948446
4184,302,11910,147,775,280,900,133,125,516,16625,1.064,182.5212316416915
4185,960,11910,132,772,306,919,174,147,642,25578,1.1836734693877549,227.7827912727386
4186,109,17997,94,912,892,1401,798,489,2574,390222,1.6319018404907977,935.9086493883898
4187,511,17997,29,924,841,1399,812,475,2574,385700,1.7094736842105265,940.7279096529453
4188,1045,17997,216,1084,407,1220,191,136,654,25976,1.4044117647058822,234.47174669882938
4189,1473,17997,115,919,839,1328,724,409,2266,296116,1.7701711491442542,831.5389347468945
4190,1106,17997,66,943,782,1358,716,415,2262,297140,1.7253012048192768,827.575374210712
4191,116,17997,111,912,864,1381,753,469,2444,353157,1.6055437100213217,887.1132960338268
4192,1224,17997,422,948,806,1297,384,349,1466,134016,1.1002865329512894,518.8997976488332
4193,1741,25815,99,505,886,1066,787,561,2696,441507,1.4028520499108734,966.4833159449779
4194,1124,25815,103,506,808,1042,705,536,2482,377880,1.3152985074626866,885.6189925696038
4195,941,25815,57,518,928,1095,871,577,2896,502567,1.5095320623916808,1044.7822739690791
4196,161,25815,104,490,907,1071,803,581,2768,466543,1.3820998278829604,991.1458015852158
4197,15,25815,46,498,923,1095,877,597,2948,523569,1.4690117252931325,1060.913757098097
4198,602,25815,119,512,926,1085,807,573,2760,462411,1.4083769633507854,989.7363285239155
4199,1060,5009,17,297,732,877,715,580,2590,414700,1.2327586206896552,920.6655201537635
4200,1184,5009,12,266,789,889,777,623,2800,484071,1.247191011235955,995.9206795724245
4201,1049,5009,21,246,732,892,711,646,2714,459306,1.1006191950464397,960.6440547882446
4202,1509,16845,118,748,875,1288,757,540,2594,408780,1.401851851851852,929.8650439714356
4203,369,16845,214,727,563,1070,349,343,1384,119707,1.0174927113702623,489.33628518637363
4204,264,16845,37,667,946,1343,909,676,3170,614484,1.3446745562130178,1132.809339650764
4205,1521,16845,76,683,914,1302,838,619,2914,518722,1.3537964458804523,1041.8277208828722
4206,370,16845,137,689,730,1310,593,621,2428,368253,0.9549114331723028,858.6559264338656
4207,921,16845,921,683,931,686,10,3,26,30,3.333333333333333,10.44030650891055
4208,558,10867,39,699,118,778,79,79,316,6241,1.0,111.72287142747452
4209,780,10867,33,695,201,819,168,124,584,20832,1.3548387096774193,208.806130178211
4210,1599,10867,28,690,119,789,91,99,380,9009,0.9191919191919192,134.46932735757994
4211,1470,10867,31,695,204,818,173,123,592,21279,1.4065040650406504,212.26869764522513
4212,609,10867,30,690,206,818,176,128,608,22528,1.375,217.6235281397671
4213,387,10867,35,687,206,819,171,132,606,22572,1.2954545454545454,216.0208323287363
4214,1469,10867,34,700,204,815,170,115,570,19550,1.4782608695652173,205.24375751773792
4215,1600,10867,43,702,203,816,160,114,548,18240,1.4035087719298245,196.45864704817652
4216,786,10867,32,697,128,774,96,77,346,7392,1.2467532467532467,123.06502346320826
4217,1565,90,35,276,474,608,439,332,1542,145748,1.3222891566265058,550.4043967847641
4218,1573,90,134,269,428,537,294,268,1124,78792,1.0970149253731345,397.81905434506274
4219,903,90,66,274,379,540,313,266,1158,83258,1.1766917293233083,410.7614879708174
4220,1712,35684,68,87,963,695,895,608,3006,544160,1.4720394736842106,1081.9838261268048
4221,1430,35684,65,113,947,628,882,515,2794,454230,1.712621359223301,1021.3466600523057
4222,891,35684,2,70,965,792,963,722,3370,695286,1.3337950138504155,1203.600016616816
4223,1090,24422,16,331,281,685,265,354,1238,93810,0.7485875706214692,442.20018091357673
4224,706,24422,80,385,201,659,121,274,790,33154,0.4416058394160584,299.5279619668254
4225,657,24422,34,618,183,681,149,63,424,9387,2.3650793650793656,161.7714437099453
4226,710,24422,44,592,172,668,128,76,408,9728,1.6842105263157894,148.86235252742716
4227,1357,24422,20,363,201,686,181,323,1008,58463,0.5603715170278638,370.25666773199373
4228,982,24422,38,402,226,683,188,281,938,52828,0.6690391459074733,338.09022464425084
4229,375,24422,22,330,275,677,253,347,1200,87791,0.729106628242075,429.4391691497179
4230,656,22723,95,416,371,654,276,238,1028,65688,1.1596638655462186,364.44478319767455
4231,1254,22723,85,476,371,637,286,161,894,46046,1.7763975155279503,328.2026812809426
4232,539,22723,94,474,359,592,265,118,766,31270,2.2457627118644066,290.0844704564517
4233,433,12667,89,548,566,861,477,313,1580,149301,1.5239616613418532,570.5243202528706
4234,650,12667,96,491,548,901,452,410,1724,185320,1.1024390243902442,610.2491294545204
4235,1668,12667,61,554,598,900,537,346,1766,185802,1.5520231213872833,638.8153097727073
4236,968,12667,111,505,335,897,224,392,1232,87808,0.5714285714285714,451.4864339047188
4237,1672,12667,100,486,558,890,458,404,1724,185032,1.1336633663366336,610.7208855115404
4238,963,12667,110,557,601,893,491,336,1654,164976,1.4613095238095235,594.9596624982235
4239,1389,12667,239,541,591,889,352,348,1400,122496,1.011494252873563,494.9828279849716
4240,909,12667,331,554,533,876,202,322,1048,65044,0.6273291925465838,380.115771838002
4241,318,33858,71,305,488,608,417,303,1440,126351,1.376237623762376,515.4590187396084
4242,925,33858,24,209,653,1006,629,797,2852,501313,0.7892095357590966,1015.3078350923921
4243,509,33858,32,215,622,1015,590,800,2780,472000,0.7375,994.0321926376429
4244,929,33858,90,244,706,949,616,705,2642,434280,0.8737588652482271,936.2056398035637
4245,1222,33858,73,278,567,990,494,712,2412,351728,0.6938202247191011,866.5910223398348
4246,581,25401,221,514,705,941,484,427,1822,206668,1.1334894613583135,645.4339625399333
4247,247,25401,133,515,681,947,548,432,1960,236736,1.2685185185185186,697.8022642554264
4248,1732,25401,216,526,664,894,448,368,1632,164864,1.2173913043478262,579.76546982379
4249,805,25401,136,528,472,718,336,190,1052,63840,1.7684210526315791,386.0
4250,1024,25401,93,528,624,868,531,340,1742,180540,1.561764705882353,630.5243849368555
4251,1508,25401,126,515,688,945,562,430,1984,241660,1.3069767441860465,707.6326730726896
4252,134,25401,83,518,684,953,601,435,2072,261435,1.3816091954022989,741.9070022583693
4253,401,4972,114,597,802,1053,688,456,2288,313728,1.5087719298245614,825.3968742368728
4254,1369,4972,52,549,786,1076,734,527,2522,386818,1.3927893738140418,903.5955953854578
4255,221,4972,49,532,803,1110,754,578,2664,435812,1.3044982698961938,950.0526301210897
4256,1067,15705,89,261,533,678,444,417,1722,185148,1.0647482014388492,609.1182151274086
4257,1347,15705,113,265,515,642,402,377,1558,151554,1.0663129973474799,551.1197691972227
4258,809,15705,60,269,580,677,520,408,1856,212160,1.2745098039215683,660.9568821035151
4259,391,30724,86,213,499,529,413,316,1458,130508,1.3069620253164558,520.0240379059414
4260,922,30724,67,214,414,537,347,323,1340,112081,1.0743034055727554,474.0653963326157
4261,118,30724,87,203,503,550,416,347,1526,144352,1.1988472622478386,541.7240995193033
4262,1706,30724,32,195,503,548,471,353,1648,166263,1.3342776203966005,588.6000339789321
4263,271,30724,79,255,326,482,247,227,948,56069,1.0881057268722467,335.46683889767706
4264,886,30724,54,205,498,539,444,334,1556,148296,1.3293413173652695,555.6005759536251
4265,592,19963,29,477,542,753,513,276,1578,141588,1.858695652173913,582.5332608529748
4266,426,19963,191,529,278,681,87,152,478,13224,0.5723684210526315,175.13708916160505
4267,1202,19963,49,537,559,826,510,289,1598,147390,1.7647058823529411,586.1919480852667
4268,865,19963,333,539,564,815,231,276,1014,63756,0.8369565217391305,359.9124893637341
4269,296,19963,33,515,330,733,297,218,1030,64746,1.3623853211009174,368.41959774148825
4270,1017,19963,28,535,555,735,527,200,1454,105400,2.635,563.6745514922596
4271,252,28804,277,306,895,868,618,562,2360,347316,1.0996441281138791,835.3250864184554
4272,531,28804,84,227,975,926,891,699,3180,622809,1.2746781115879828,1132.467218068585
4273,806,28804,61,257,973,938,912,681,3186,621072,1.3392070484581498,1138.2025303082048
4274,1141,28804,351,267,741,594,390,327,1434,127530,1.1926605504587156,508.94891688655747
4275,973,28804,158,259,482,506,324,247,1142,80028,1.311740890688259,407.4125673073917
4276,907,28804,45,228,496,874,451,646,2194,291346,0.6981424148606811,787.8559513007438
4277,1138,28804,110,279,955,895,845,616,2922,520520,1.3717532467532467,1045.696418660789
4278,682,23104,103,1152,128,1179,25,27,104,675,0.925925925925926,36.796738985948195
4279,952,23104,106,1156,124,1179,18,23,82,414,0.7826086956521741,29.206163733020468
4280,525,23104,107,1156,119,1179,12,23,70,276,0.5217391304347826,25.942243542145693
4281,636,23104,100,1151,130,1180,30,29,118,870,1.0344827586206895,41.72529209005013
4282,752,23104,83,1147,138,1185,55,38,186,2090,1.4473684210526316,66.85057965343307
4283,472,23104,96,1155,130,1183,34,28,124,952,1.2142857142857142,44.04543109109048
4284,1549,23104,106,1149,136,1186,30,37,134,1110,0.8108108108108109,47.634021455258214
4285,27,23104,101,1154,129,1182,28,28,112,784,1.0,39.59797974644666
4286,68,23104,101,1146,131,1179,30,33,126,990,0.9090909090909092,44.598206241955516
4287,903,48,52,1033,144,1098,92,65,314,5980,1.4153846153846157,112.6454615153225
4288,366,48,50,1029,163,1103,113,74,374,8362,1.5270270270270268,135.07405376311175
4289,141,48,55,1029,158,1102,103,73,352,7519,1.4109589041095891,126.24579200908045
4290,1097,32337,108,766,512,1069,404,303,1414,122412,1.3333333333333333,505.0
4291,161,32337,174,747,447,1046,273,299,1144,81627,0.9130434782608696,404.88269906233336
4292,656,32337,208,810,480,1000,272,190,924,51680,1.431578947368421,331.78908963376114
4293,1684,32337,206,823,487,1013,281,190,942,53390,1.4789473684210526,339.2064268259079
4294,1676,32337,231,801,448,1082,217,281,996,60977,0.7722419928825622,355.0352095215346
4295,1444,17653,33,593,76,617,43,24,134,1032,1.7916666666666667,49.24428900898052
4296,489,17653,55,600,66,605,11,5,32,55,2.2,12.083045973594572
4297,1507,17653,34,591,47,597,13,6,38,78,2.1666666666666665,14.317821063276353
4298,909,17653,31,594,69,608,38,14,104,532,2.7142857142857144,40.496913462633174
4299,531,17653,33,592,75,615,42,23,130,966,1.826086956521739,47.885279575251516
4300,1022,17653,31,592,75,615,44,23,134,1012,1.9130434782608696,49.64876634922564
4301,965,15139,34,529,453,901,419,372,1582,155868,1.1263440860215057,560.3079510412109
4302,961,15139,166,599,393,774,227,175,804,39725,1.2971428571428572,286.6251907980176
4303,809,15139,49,532,490,896,441,364,1610,160524,1.2115384615384617,571.8190273154611
4304,1067,15139,31,516,518,893,487,377,1728,183599,1.2917771883289124,615.871739893949
4305,1136,15139,32,538,445,901,413,363,1552,149919,1.137741046831956,549.8527075499402
4306,1347,15139,83,517,417,825,334,308,1284,102872,1.0844155844155845,454.33467840348703
4307,537,15139,126,723,333,835,207,112,638,23184,1.8482142857142856,235.35717537394095
4308,1202,19959,483,551,864,1206,381,655,2072,249555,0.5816793893129771,757.7506186074677
4309,865,19959,457,578,903,1216,446,638,2168,284548,0.6990595611285266,778.4343260673953
4310,296,19959,477,561,903,947,426,386,1624,164436,1.1036269430051813,574.8669411263793
4311,1504,19959,715,602,787,714,72,112,368,8064,0.6428571428571429,133.1465358167459
4312,426,19959,624,899,701,985,77,86,326,6622,0.8953488372093024,115.43396380615195
4313,1017,19959,442,556,982,1037,540,481,2042,259740,1.1226611226611227,723.160424802132
4314,95,7720,43,785,106,843,63,58,242,3654,1.0862068965517242,85.63293758829018
4315,1442,7720,59,793,104,838,45,45,180,2025,1.0,63.63961030678928
4316,306,7720,52,792,97,843,45,51,192,2295,0.8823529411764706,68.01470429252781
4317,695,7720,54,795,109,838,55,43,196,2365,1.2790697674418603,69.81403870282824
4318,1389,7720,52,790,101,840,49,50,198,2450,0.98,70.00714249274856
4319,182,3816,154,820,440,1077,286,257,1086,73502,1.11284046692607,384.50617680344226
4320,948,3816,286,1210,370,1311,84,101,370,8484,0.8316831683168316,131.36590120727678
4321,1004,3816,277,1213,367,1278,90,65,310,5850,1.3846153846153846,111.01801655587259
4322,577,3816,243,1189,368,1315,125,126,502,15750,0.992063492063492,177.48521065147935
4323,1537,3816,142,827,442,1113,300,286,1172,85800,1.048951048951049,414.48281025876094
4324,335,3816,239,1188,385,1333,146,145,582,21170,1.006896551724138,205.7692882818036
4325,348,3816,288,1201,352,1304,64,103,334,6592,0.6213592233009708,121.26417442921878
4326,1711,3816,283,1202,383,1313,100,111,422,11100,0.9009009009009008,149.40214188558343
4327,129,3816,239,1191,415,1305,176,114,580,20064,1.5438596491228067,209.69501663129716
4328,946,3816,272,836,275,839,3,3,12,9,1.0,4.242640687119285
4329,339,25014,29,523,159,621,130,98,456,12740,1.326530612244898,162.80049139974977
4330,952,25014,41,525,138,599,97,74,342,7178,1.3108108108108107,122.00409829181969
4331,189,25014,28,507,157,629,129,122,502,15738,1.0573770491803278,177.55280904564702
4332,132,25014,91,509,100,512,9,3,24,27,3.0,9.486832980505138
4333,1056,25014,29,515,142,629,113,114,454,12882,0.9912280701754386,160.51479682571323
4334,687,25014,35,521,137,592,102,71,346,7242,1.4366197183098592,124.27791436936813
4335,1228,25014,30,516,151,628,121,112,466,13552,1.0803571428571428,164.87874332369228
4336,242,25014,35,520,169,630,134,110,488,14740,1.2181818181818185,173.3666634621547
4337,957,25014,31,517,150,630,119,113,464,13447,1.0530973451327434,164.10362579784763
4338,349,25014,29,513,129,612,100,99,398,9900,1.0101010101010102,140.71602609511115
4339,1581,15840,136,676,644,976,508,300,1616,152400,1.6933333333333334,589.9694907365973
4340,1684,15840,42,647,659,954,617,307,1848,189419,2.009771986970684,689.1574566091555
4341,552,15840,166,652,610,942,444,290,1468,128760,1.5310344827586206,530.3168863990661
4342,1470,25962,25,376,348,634,323,258,1162,83334,1.251937984496124,413.3920657196991
4343,119,25962,33,394,401,675,368,281,1298,103408,1.3096085409252671,463.0172782953137
4344,1046,25962,73,402,325,702,252,300,1104,75600,0.84,391.7958652155482
4345,54,2373,99,655,902,1216,803,561,2728,450483,1.431372549019608,979.5560218793001
4346,778,2373,105,621,761,1172,656,551,2414,361456,1.1905626134301268,856.7012314687075
4347,1154,2373,140,704,832,1073,692,369,2122,255348,1.8753387533875336,784.23529632375
4348,1671,9044,47,292,428,629,381,337,1436,128397,1.1305637982195846,508.65508942701047
4349,964,9044,15,309,412,644,397,335,1464,132995,1.1850746268656716,519.4554841369951
4350,909,9044,16,271,344,583,328,312,1280,102336,1.051282051282051,452.6897392254435
4351,809,9044,18,268,390,637,372,369,1482,137268,1.008130081300813,523.9704190123714
4352,1663,9044,17,282,385,621,368,339,1414,124752,1.0855457227138643,500.3448810570565
4353,1564,9044,44,271,404,635,360,364,1448,131040,0.989010989010989,511.95312285403634
4354,1242,9044,19,284,383,635,364,351,1430,127764,1.037037037037037,505.6649088081948
4355,905,9044,164,342,392,571,228,229,914,52212,0.9956331877729258,323.1485726411305
4356,140,9044,122,368,408,529,286,161,894,46046,1.7763975155279503,328.2026812809426
4357,753,8271,75,539,509,824,434,285,1438,123690,1.5228070175438595,519.2119027911436
4358,634,8271,45,534,495,836,450,302,1504,135900,1.4900662251655632,541.9446466199292
4359,899,8271,52,562,505,831,453,269,1444,121857,1.6840148698884758,526.8491245128913
4360,421,8271,69,547,324,778,255,231,972,58905,1.103896103896104,344.0726667435238
4361,25,8271,92,569,326,757,234,188,844,43992,1.24468085106383,300.1666203960727
4362,1661,8271,105,689,483,842,378,153,1062,57834,2.4705882352941178,407.7903873315309
4363,846,8271,46,530,518,852,472,322,1588,151984,1.4658385093167705,571.3737830877437
4364,635,8271,67,530,485,817,418,287,1410,119966,1.456445993031359,507.0433906481772
4365,291,8271,71,535,376,791,305,256,1122,78080,1.19140625,398.19718733311015
4366,1430,8271,60,548,510,856,450,308,1516,138600,1.4610389610389611,545.3109204848184
4367,1373,8271,64,594,349,825,285,231,1032,65835,1.2337662337662338,366.8596461863856
4368,341,8271,63,559,488,796,425,237,1324,100725,1.7932489451476794,486.6148374227814
4369,1097,5709,19,333,849,953,830,620,2900,514600,1.3387096774193548,1036.001930500132
4370,313,5709,22,317,883,967,861,650,3022,559650,1.3246153846153843,1078.805357791664
4371,1525,5709,68,331,896,963,828,632,2920,523296,1.3101265822784811,1041.6371729157902
4372,1247,32442,43,772,204,896,161,124,570,19964,1.2983870967741935,203.21663317750347
4373,1244,32442,75,814,146,879,71,65,272,4615,1.0923076923076922,96.26006440887103
4374,874,32442,75,813,141,881,66,68,268,4488,0.9705882352941176,94.76286192385707
4375,656,32442,63,817,150,873,87,56,286,4872,1.5535714285714286,103.46496991735899
4376,1513,32442,41,764,247,896,206,132,676,27192,1.5606060606060606,244.6630335788388
4377,1351,32442,59,793,199,876,140,83,446,11620,1.686746987951807,162.75441622272496
4378,100,32442,54,784,192,886,138,102,480,14076,1.3529411764705883,171.6041957529011
4379,1684,32442,77,817,162,883,85,66,302,5610,1.2878787878787878,107.61505470890214
4380,476,20372,74,694,608,1068,534,374,1816,199716,1.4278074866310158,651.9447829379418
4381,71,20372,99,688,580,1029,481,341,1644,164021,1.4105571847507332,589.6117366538763
4382,1435,20372,41,723,554,1079,513,356,1738,182628,1.4410112359550562,624.423734334306
4383,1399,5797,86,328,591,874,505,546,2102,275730,0.9249084249084251,743.7344956367158
4384,1694,5797,39,296,690,947,651,651,2604,423801,1.0,920.6530291048849
4385,1097,5797,38,294,709,1013,671,719,2780,482449,0.933240611961057,983.4642850658075
4386,332,9395,190,1076,628,1545,438,469,1814,205422,0.9339019189765458,641.7203440752054
4387,421,9395,211,1213,585,1522,374,309,1366,115566,1.2103559870550162,485.1360633884065
4388,748,9395,266,1219,609,1492,343,273,1232,93639,1.2564102564102564,438.3811127318329
4389,71,9395,188,1141,740,1569,552,428,1960,236256,1.2897196261682242,698.489799496027
4390,1719,9395,220,1237,555,1491,335,254,1178,85090,1.3188976377952757,420.4057563830448
4391,641,9395,180,1141,625,1521,445,380,1650,169100,1.1710526315789471,585.1709152034131
4392,1277,9395,196,1248,675,1477,479,229,1416,109691,2.091703056768559,530.9256068414859
4393,1231,9395,226,1237,621,1512,395,275,1340,108625,1.4363636363636365,481.3003220443552
4394,1279,9395,209,1183,703,1552,494,369,1726,182286,1.3387533875338753,616.601167692699
4395,1454,26006,52,821,271,981,219,160,758,35040,1.36875,271.22131184698594
4396,1508,26006,47,824,260,985,213,161,748,34293,1.3229813664596273,267.00187265260894
4397,581,26006,48,831,271,983,223,152,750,33896,1.4671052631578947,269.8758974047145
4398,761,26006,55,823,199,956,144,133,554,19152,1.0827067669172932,196.02295783912658
4399,359,26006,68,821,173,909,105,88,386,9240,1.193181818181818,137.0
4400,592,26006,48,818,276,990,228,172,800,39216,1.3255813953488371,285.60112044598145
4401,387,9122,137,388,569,813,432,425,1714,183600,1.016470588235294,606.0107259776843
4402,178,9122,119,409,521,793,402,384,1572,154368,1.046875,555.9316504751281
4403,1319,9122,148,432,587,813,439,381,1640,167259,1.1522309711286092,581.2761822060147
4404,1388,34245,160,1122,524,1381,364,259,1246,94276,1.4054054054054057,446.7404167970478
4405,32,34245,179,1070,580,1411,401,341,1484,136741,1.1759530791788857,526.3857900817612
4406,88,34245,204,1039,508,1386,304,347,1302,105488,0.8760806916426513,461.3296001775737
4407,94,34245,173,1047,583,1420,410,373,1566,152930,1.099195710455764,554.2824189887318
4408,250,34245,113,1047,592,1418,479,371,1700,177709,1.2911051212938005,605.8729239700351
4409,1389,14408,57,1088,536,1723,479,635,2228,304165,0.7543307086614173,795.4030424885235
4410,1383,14408,67,1076,536,1723,469,647,2232,303443,0.7248840803709428,799.1057501983076
4411,1207,14408,81,1102,526,1694,445,592,2074,263440,0.7516891891891891,740.6004320819695
4412,1668,12669,133,750,198,872,65,122,374,7930,0.5327868852459017,138.23530663329106
4413,909,12669,133,754,199,886,66,132,396,8712,0.5,147.58048651498612
4414,1672,12669,122,746,203,874,81,128,418,10368,0.6328125,151.47607071745688
4415,1389,12669,48,744,208,881,160,137,594,21920,1.167883211678832,210.63950246807934
4416,963,12669,140,750,205,873,65,123,376,7995,0.5284552845528455,139.11865439257238
4417,650,12669,112,740,229,878,117,138,510,16146,0.8478260869565217,180.92263539977523
4418,1054,18064,125,449,815,1098,690,649,2678,447810,1.0631741140215716,947.2597320692989
4419,122,18064,26,432,928,1102,902,670,3144,604340,1.346268656716418,1123.6120326874398
4420,1659,18064,91,454,929,1089,838,635,2946,532130,1.3196850393700787,1051.412858966448
4421,678,21781,179,936,330,1381,151,445,1192,67195,0.3393258426966292,469.9212700016887
4422,1409,21781,98,929,380,1379,282,450,1464,126900,0.6266666666666667,531.0593187206115
4423,274,21781,187,924,349,1384,162,460,1244,74520,0.3521739130434783,487.6925260858526
4424,1173,21781,205,958,338,1258,133,300,866,39900,0.44333333333333336,328.16002194051606
4425,1315,21781,177,949,376,1380,199,431,1260,85769,0.4617169373549884,474.72307717236583
4426,519,35699,112,654,283,829,171,175,692,29925,0.9771428571428572,244.6752950340512
4427,1430,35699,117,650,241,776,124,126,500,15624,0.984126984126984,176.7823520603796
4428,849,35699,94,653,251,796,157,143,600,22451,1.097902097902098,212.3628969476542
4429,1636,20917,32,391,210,489,178,98,552,17444,1.8163265306122451,203.19448811422026
4430,886,20917,71,392,229,487,158,95,506,15010,1.6631578947368422,184.36105879496353
4431,793,20917,61,371,226,507,165,136,602,22440,1.213235294117647,213.82469455140114
4432,1321,20917,62,382,219,499,157,117,548,18369,1.3418803418803418,195.80091930325557
4433,1272,20917,60,380,247,504,187,124,622,23188,1.5080645161290325,224.37691503361035
4434,1644,20917,56,375,230,483,174,108,564,18792,1.6111111111111112,204.79257799051214
4435,1702,20917,96,392,170,480,74,88,324,6512,0.8409090909090909,114.97825881443848
4436,1556,28030,66,722,182,800,116,78,388,9048,1.4871794871794872,139.7855500400524
4437,1198,28030,71,716,229,819,158,103,522,16274,1.5339805825242718,188.60805921274945
4438,1206,28030,72,717,184,805,112,88,400,9856,1.2727272727272727,142.43595051811886
4439,962,28030,63,723,199,816,136,93,458,12648,1.4623655913978495,164.7573974060042
4440,818,28030,72,720,240,815,168,95,526,15960,1.7684210526315791,193.0
4441,1671,28030,72,720,234,813,162,93,510,15066,1.7419354838709675,186.79668091269716
4442,39,28030,48,721,228,814,180,93,546,16740,1.935483870967742,202.60552805883654
4443,44,28030,59,715,233,816,174,101,550,17574,1.7227722772277227,201.1889659002203
4444,698,28030,71,719,148,810,77,91,336,7007,0.8461538461538461,119.20570456148481
4445,494,8438,79,918,317,1095,238,177,830,42126,1.3446327683615822,296.60242750186654
4446,909,8438,70,956,223,1098,153,142,590,21726,1.0774647887323945,208.7414668914636
4447,1384,8438,73,962,352,1089,279,127,812,35433,2.1968503937007875,306.54526582545685
4448,256,8438,96,974,123,1031,27,57,168,1539,0.4736842105263158,63.071388124885914
4449,1671,8438,60,900,354,1101,294,201,990,59094,1.462686567164179,356.1418256818483
4450,815,8438,118,890,367,1078,249,188,874,46812,1.324468085106383,312.00160255998685
4451,206,8438,107,1010,177,1030,70,20,180,1400,3.5,72.80109889280519
4452,1560,8438,79,917,365,1090,286,173,918,49478,1.653179190751445,334.2528982671654
4453,1299,13871,638,787,906,1003,268,216,968,57888,1.2407407407407407,344.20923869065456
4454,161,13871,160,699,929,1199,769,500,2538,384500,1.538,917.2573248549177
4455,315,13871,172,741,900,1182,728,441,2338,321048,1.6507936507936507,851.1550974998622
4456,310,13871,738,565,773,751,35,186,442,6510,0.1881720430107527,189.2643653728826
4457,496,13871,586,715,908,1188,322,473,1590,152306,0.6807610993657506,572.2001398112377
4458,449,13871,642,703,888,1077,246,374,1240,92004,0.6577540106951871,447.6516502817788
4459,1739,13871,558,625,928,1214,370,589,1918,217930,0.6281833616298812,695.5724261354816
4460,552,13871,517,708,991,1204,474,496,1940,235104,0.9556451612903226,686.0699672773908
4461,1308,13871,76,702,335,1137,259,435,1388,112665,0.5954022988505747,506.26672811868644
4462,1466,13871,247,755,874,1160,627,405,2064,253935,1.548148148148148,746.4274914551312
4463,182,23334,169,644,738,1159,569,515,2168,293035,1.104854368932039,767.4542331631249
4464,752,23334,77,655,758,1140,681,485,2332,330285,1.4041237113402059,836.053826018397
4465,952,23334,177,670,697,1111,520,441,1922,229320,1.1791383219954648,681.821824232695
4466,737,13967,69,1024,276,1165,207,141,696,29187,1.4680851063829787,250.4595775769016
4467,1046,13967,57,1034,311,1248,254,214,936,54356,1.1869158878504673,332.13250367887815
4468,1371,13967,51,1010,385,1249,334,239,1146,79826,1.3974895397489542,410.7030557470933
4469,1322,13967,180,1012,287,1101,107,89,392,9523,1.2022471910112358,139.17614738165446
4470,1039,13967,82,1041,379,1239,297,198,990,58806,1.5,356.9495762709349
4471,1037,13967,169,1018,363,1236,194,218,824,42292,0.8899082568807339,291.82186347153635
4472,387,13967,68,1016,385,1244,317,228,1090,72276,1.3903508771929824,390.4779123074697
4473,909,17324,58,763,334,920,276,157,866,43332,1.7579617834394905,317.52952618614853
4474,1194,17324,61,760,343,921,282,161,886,45402,1.751552795031056,324.7229588433808
4475,1075,17324,56,782,331,905,275,123,796,33825,2.2357723577235773,301.2540456159884
4476,238,13134,109,861,267,983,158,122,560,19276,1.2950819672131149,199.61963831246663
4477,629,13134,109,813,268,1026,159,213,744,33867,0.7464788732394366,265.80067720004024
4478,1182,13134,109,861,270,1014,161,153,628,24633,1.0522875816993464,222.10357943986403
4479,501,23416,53,762,64,767,11,5,32,55,2.2,12.083045973594572
4480,220,23416,50,759,60,770,10,11,42,110,0.9090909090909092,14.866068747318506
4481,1370,23416,51,759,66,768,15,9,48,135,1.6666666666666667,17.4928556845359
4482,833,23416,52,759,63,768,11,9,40,99,1.2222222222222223,14.212670403551895
4483,798,23416,51,758,68,769,17,11,56,187,1.5454545454545454,20.248456731316587
4484,930,23416,51,760,67,768,16,8,48,128,2.0,17.88854381999832
4485,119,23416,50,762,69,767,19,5,48,95,3.8,19.6468827043885
4486,998,23416,53,762,64,766,11,4,30,44,2.75,11.704699910719626
4487,832,23416,51,759,68,769,17,10,54,170,1.7,19.72308292331602
4488,1223,23416,52,758,66,768,14,10,48,140,1.4,17.204650534085253
4489,1595,23416,52,762,58,766,6,4,20,24,1.5,7.211102550927978
4490,1719,27152,168,814,549,954,381,140,1042,53340,2.7214285714285715,405.90762495917716
4491,1015,27152,121,809,553,1029,432,220,1304,95040,1.963636363636364,484.79273921955553
4492,519,27152,134,752,536,1005,402,253,1310,101706,1.5889328063241106,474.9873682530937
4493,955,27152,112,759,538,1022,426,263,1378,112038,1.6197718631178708,500.64458451080844
4494,1187,27152,148,808,523,959,375,151,1052,56625,2.4834437086092715,404.2598174441778
4495,638,27152,101,782,553,1011,452,229,1362,103508,1.9737991266375543,506.7001085454788
4496,755,15953,36,736,914,1308,878,572,2900,502216,1.534965034965035,1047.887398530968
4497,203,15953,135,784,829,1288,694,504,2396,349776,1.3769841269841268,857.7015798050043
4498,360,15953,270,796,907,1300,637,504,2282,321048,1.2638888888888888,812.271506332704
4499,1730,15953,172,807,897,1318,725,511,2472,370475,1.4187866927592956,886.9870348545124
4500,1344,15953,167,760,880,1313,713,553,2532,394289,1.2893309222423146,902.3181257184186
4501,909,15953,75,774,687,1131,612,357,1938,218484,1.7142857142857142,708.5146434619401
4502,1452,15953,101,764,911,1298,810,534,2688,432540,1.5168539325842696,970.1834878001171
4503,651,15953,342,786,865,1273,523,487,2020,254701,1.0739219712525667,714.6313735066492
4504,1508,15953,75,767,853,1323,778,556,2668,432568,1.3992805755395683,956.2531045701237
4505,211,19394,40,388,269,582,229,194,846,44426,1.1804123711340206,300.1283058959951
4506,1153,19394,22,396,274,572,252,176,856,44352,1.431818181818182,307.37599125501004
4507,1517,19394,114,391,315,501,201,110,622,22110,1.8272727272727276,229.13096691630312
4508,379,19394,35,377,285,576,250,199,898,49750,1.256281407035176,319.53247096343745
4509,936,30965,74,347,597,601,523,254,1554,132842,2.059055118110236,581.4163740384338
4510,998,30965,89,342,599,585,510,243,1506,123930,2.098765432098765,564.9327393592976
4511,1528,30965,126,416,290,546,164,130,588,21320,1.2615384615384615,209.27493877672023
4512,398,30965,257,477,430,598,173,121,588,20933,1.4297520661157024,211.11608181282637
4513,669,30965,105,362,537,661,432,299,1462,129168,1.4448160535117056,525.3808142671371
4514,515,30965,81,277,593,659,512,382,1788,195584,1.3403141361256543,638.8020037539018
4515,909,14056,301,702,684,1094,383,392,1550,150136,0.9770408163265306,548.0447062056161
4516,1207,14056,362,621,774,1069,412,448,1720,184576,0.9196428571428572,608.6443953574205
4517,1241,14056,321,700,693,1091,372,391,1526,145452,0.9514066496163684,539.6897256757812
4518,453,33046,152,1139,506,1408,354,269,1246,95226,1.3159851301115242,444.6088168266572
4519,1046,33046,88,1145,493,1414,405,269,1348,108945,1.5055762081784387,486.1954339563464
4520,934,33046,46,1133,510,1435,464,302,1532,140128,1.5364238410596027,553.6244214266563
4521,952,23986,61,201,590,685,529,484,2026,256036,1.0929752066115703,717.0055787788544
4522,26,23986,25,208,654,680,629,472,2202,296888,1.3326271186440677,786.4000254323496
4523,1238,23986,28,212,642,647,614,435,2098,267090,1.4114942528735632,752.4765777085689
4524,1337,23986,55,190,582,681,527,491,2036,258757,1.0733197556008147,720.2846659481236
4525,1235,23986,25,173,762,724,737,551,2576,406087,1.337568058076225,920.2010649852564
4526,289,23986,150,318,445,651,295,333,1256,98235,0.8858858858858859,444.8752634166121
4527,1663,11212,26,479,48,492,22,13,70,286,1.6923076923076923,25.553864678361276
4528,1239,11212,26,479,49,492,23,13,72,299,1.7692307692307692,26.419689627245813
4529,140,11212,36,478,48,493,12,15,54,180,0.8,19.209372712298546
4530,1502,11212,26,480,49,490,23,10,66,230,2.3,25.079872407968907
4531,805,11212,34,481,48,492,14,11,50,154,1.2727272727272727,17.804493814764857
4532,1692,285,141,339,337,505,196,166,724,32536,1.1807228915662649,256.8501508662201
4533,831,285,62,343,353,557,291,214,1010,62274,1.3598130841121496,361.2160018603827
4534,1351,285,130,365,349,575,219,210,858,45990,1.042857142857143,303.41555662160766
4535,636,22998,345,623,436,818,91,195,572,17745,0.4666666666666667,215.18828964420902
4536,15,22998,119,593,461,832,342,239,1162,81738,1.4309623430962344,417.2349458039199
4537,752,22998,79,571,495,908,416,337,1506,140192,1.2344213649851632,535.3737012592233
4538,27,22998,141,583,411,759,270,176,892,47520,1.5340909090909092,322.29799875270714
4539,1549,22998,131,587,415,833,284,246,1060,69864,1.1544715447154472,375.7286254732264
4540,576,22998,291,663,440,808,149,145,588,21605,1.0275862068965518,207.90863377935992
4541,1508,5205,151,696,197,779,46,83,258,3818,0.5542168674698795,94.89467845985885
4542,1389,5205,44,706,195,807,151,101,504,15251,1.495049504950495,181.6645259812713
4543,42,5205,41,707,206,802,165,95,520,15675,1.7368421052631582,190.3943276465977
4544,493,5647,161,650,727,1221,566,571,2274,323186,0.9912434325744308,803.9881839927749
4545,967,5647,192,703,731,1214,539,511,2100,275429,1.0547945205479452,742.7260598632581
4546,1451,5647,139,683,767,1162,628,479,2214,300812,1.3110647181628392,789.8259301896843
4547,149,5647,264,584,604,1247,340,663,2006,225420,0.5128205128205128,745.0966380275783
4548,819,5647,54,619,783,1215,729,596,2650,434484,1.2231543624161074,941.6246598300195
4549,809,5647,118,709,773,1235,655,526,2362,344530,1.245247148288973,840.060116896404
4550,90,5647,154,630,747,1227,593,597,2380,354021,0.9932998324958124,841.4618232575973
4551,969,5647,434,806,612,963,178,157,670,27946,1.1337579617834397,237.34573937612615
4552,865,5647,174,652,751,1250,577,598,2350,345046,0.9648829431438128,830.9831526571402
4553,1723,5647,73,623,778,1267,705,644,2698,454020,1.0947204968944102,954.8617701007827
4554,1065,5647,313,913,436,973,123,60,366,7380,2.05,136.85393673548452
4555,137,5647,120,643,785,1274,665,631,2592,419615,1.0538827258320127,916.7256950691411
4556,1510,23261,157,988,272,1150,115,162,554,18630,0.7098765432098766,198.66806487203723
4557,1357,23261,131,981,317,1160,186,179,730,33294,1.0391061452513966,258.14143410154054
4558,103,23261,173,1006,238,1109,65,103,336,6695,0.6310679611650486,121.79490958164057
4559,1630,23261,139,969,334,1169,195,200,790,39000,0.975,279.32955446926843
4560,375,23261,119,979,334,1161,215,182,794,39130,1.1813186813186811,281.6895454219059
4561,706,23261,163,1006,220,1041,57,35,184,1995,1.6285714285714286,66.88796603276258
4562,710,23261,128,968,262,1149,134,181,630,24254,0.7403314917127072,225.20435164534453
4563,1090,23261,112,983,248,1128,136,145,562,19720,0.9379310344827586,198.79889335708083
4564,861,9523,51,855,86,891,35,36,142,1260,0.9722222222222222,50.20956084253277
4565,909,9523,50,854,60,859,10,5,30,50,2.0,11.180339887498949
4566,809,9523,48,855,86,892,38,37,150,1406,1.027027027027027,53.03772242470448
4567,1412,15331,250,726,406,890,156,164,640,25584,0.951219512195122,226.34486961272174
4568,1598,15331,222,670,543,961,321,291,1224,93411,1.1030927835051547,433.2689695789441
4569,785,15331,179,641,526,949,347,308,1310,106876,1.1266233766233766,463.97521485527653
4570,1174,15331,207,681,595,898,388,217,1210,84196,1.7880184331797235,444.55933237308153
4571,1212,11174,232,901,482,1150,250,249,998,62250,1.0040160642570282,352.8469923352047
4572,831,11174,237,941,502,1150,265,209,948,55385,1.2679425837320577,337.4996296294264
4573,1687,11174,235,924,494,1147,259,223,964,57757,1.1614349775784754,341.77477964296895
4574,523,20305,68,653,115,706,47,53,200,2491,0.8867924528301887,70.83784299369935
4575,1281,20305,77,657,125,699,48,42,180,2016,1.1428571428571428,63.7808748764079
4576,843,20305,77,658,127,684,50,26,152,1300,1.9230769230769231,56.356011214421486
4577,234,20305,92,650,131,691,39,41,160,1599,0.951219512195122,56.586217403180434
4578,854,20305,79,654,107,709,28,55,166,1540,0.509090909090909,61.71709649683789
4579,580,20305,73,643,130,714,57,71,256,4047,0.8028169014084507,91.0494371207203
4580,1614,20305,85,647,128,702,43,55,196,2365,0.7818181818181819,69.81403870282824
4581,852,20305,74,652,122,703,48,51,198,2448,0.9411764705882352,70.03570517957252
4582,71,20305,77,656,133,703,56,47,206,2632,1.1914893617021276,73.10950690573696
4583,934,12788,100,598,387,869,287,271,1116,77777,1.059040590405904,394.72775428135276
4584,1102,12788,123,603,124,604,1,1,4,1,1.0,1.4142135623730951
4585,1638,12788,127,599,394,867,267,268,1070,71556,0.996268656716418,378.3027887816848
4586,781,12788,122,605,377,869,255,264,1038,67320,0.9659090909090908,367.04359414107745
4587,3,12788,106,603,418,865,312,262,1148,81744,1.1908396946564883,407.41624906230726
4588,112,12233,42,435,247,611,205,176,762,36080,1.1647727272727273,270.1869722988138
4589,1469,12233,50,419,255,622,205,203,816,41615,1.0098522167487685,288.50303291300077
4590,66,12233,23,436,301,636,278,200,956,55600,1.39,342.4675167077894
4591,161,32264,119,345,435,607,316,262,1156,82792,1.2061068702290076,410.48751503547584
4592,1468,32264,159,390,384,611,225,221,892,49725,1.0180995475113122,315.38230768386484
4593,379,32264,173,385,346,591,173,206,758,35638,0.8398058252427184,269.0074348414928
4594,107,32264,155,375,445,612,290,237,1054,68730,1.2236286919831223,374.52503254121746
4595,872,32264,84,364,353,613,269,249,1036,66981,1.0803212851405624,366.55422518366913
4596,1635,4936,153,263,474,577,321,314,1270,100794,1.0222929936305734,449.040087297337
4597,1116,4936,159,278,519,620,360,342,1404,123120,1.0526315789473684,496.552112068814
4598,401,4936,92,286,521,610,429,324,1506,138996,1.3240740740740742,537.6030133844117
4599,294,4582,30,359,979,1026,949,667,3232,632983,1.4227886056971517,1159.9525852378622
4600,197,4582,255,468,428,554,173,86,518,14878,2.011627906976744,193.19679086361657
4601,1508,4582,360,445,746,946,386,501,1774,193386,0.7704590818363274,632.4531603209838
4602,1389,4582,34,394,977,1020,943,626,3138,590318,1.5063897763578276,1131.867925157348
4603,242,3019,117,637,641,1077,524,440,1928,230560,1.1909090909090907,684.2338781440159
4604,1281,3019,262,628,502,1089,240,461,1402,110640,0.5206073752711496,519.7316615331415
4605,407,3019,289,770,455,1016,166,246,824,40836,0.6747967479674797,296.76927064640637
4606,471,3019,255,631,476,1089,221,458,1358,101218,0.4825327510917031,508.53220153693314
4607,464,3019,187,676,518,1070,331,394,1450,130414,0.8401015228426396,514.5842982447093
4608,335,3019,212,657,519,1077,307,420,1454,128940,0.7309523809523809,520.2393679836234
4609,404,3019,229,636,514,1083,285,447,1464,127395,0.6375838926174496,530.1264000217307
4610,577,3019,221,631,483,1075,262,444,1412,116328,0.5900900900900901,515.5385533594941
4611,192,3019,262,748,383,1005,121,257,756,31097,0.4708171206225681,284.05985284795173
4612,391,34170,35,706,522,976,487,270,1514,131490,1.803703703703704,556.8383966645978
4613,506,34170,52,719,521,1004,469,285,1508,133665,1.6456140350877193,548.8041545032253
4614,169,34170,36,698,410,1003,374,305,1358,114070,1.2262295081967214,482.5981765402766
4615,1529,34170,63,691,501,1021,438,330,1536,144540,1.3272727272727274,548.4013129087128
4616,1408,34170,68,740,483,1022,415,282,1394,117030,1.4716312056737588,501.745951652826
4617,1222,34170,115,715,357,1000,242,285,1054,68970,0.8491228070175438,373.8836717483126
4618,1704,34170,50,675,517,1020,467,345,1624,161115,1.3536231884057972,580.6151909828058
4619,1046,34170,80,750,485,978,405,228,1266,92340,1.7763157894736843,464.7676839023987
4620,615,34170,33,708,520,1007,487,299,1572,145613,1.62876254180602,571.4630346750348
4621,1470,22476,433,880,662,1262,229,382,1222,87478,0.5994764397905761,445.3818586336898
4622,1595,22476,408,848,560,1062,152,214,732,32528,0.7102803738317757,262.48809496813374
4623,65,22476,236,821,728,1308,492,487,1958,239604,1.0102669404517457,692.2665671545897
4624,110,22476,425,929,655,1292,230,363,1186,83490,0.6336088154269972,429.7313114028346
4625,1222,22476,395,897,698,1261,303,364,1334,110292,0.8324175824175825,473.60848809961163
4626,276,20243,123,285,401,535,278,250,1056,69500,1.112,373.8769851167627
4627,988,20243,148,284,423,647,275,363,1276,99825,0.7575757575757576,455.40531397865794
4628,1221,20243,111,251,467,653,356,402,1516,143112,0.8855721393034826,536.9729974589039
4629,227,20243,98,253,472,653,374,400,1548,149600,0.935,547.6093498106109
4630,1321,20243,134,251,467,656,333,405,1476,134865,0.8222222222222222,524.3224198906623
4631,1362,20243,195,329,395,587,200,258,916,51600,0.7751937984496124,326.44141894067303
4632,1225,29563,95,963,217,1051,122,88,420,10736,1.3863636363636365,150.42606157179014
4633,560,29563,115,986,221,1076,106,90,392,9540,1.1777777777777778,139.05394636614957
4634,8,29563,120,957,221,1078,101,121,444,12221,0.8347107438016529,157.61345120261785
4635,932,29563,116,971,205,1069,89,98,374,8722,0.9081632653061223,132.38202294873727
4636,728,29563,114,969,211,1074,97,105,404,10185,0.923809523809524,142.9475428260311
4637,382,1587,38,717,86,761,48,44,184,2112,1.0909090909090908,65.11528238439882
4638,379,1587,37,722,48,733,11,11,44,121,1.0,15.556349186104045
4639,831,1587,36,703,91,759,55,56,222,3080,0.9821428571428572,78.49203781276162
4640,1690,1587,37,702,90,760,53,58,222,3074,0.913793103448276,78.56844150166147
4641,161,8723,268,740,561,1196,293,456,1498,133608,0.6425438596491229,542.0193723475204
4642,1210,8723,49,698,552,1179,503,481,1968,241943,1.0457380457380456,695.9669532384422
4643,1455,8723,70,693,551,1037,481,344,1650,165464,1.3982558139534884,591.3518411233705
4644,866,8723,94,698,524,1167,430,469,1798,201670,0.9168443496801706,636.2868849819239
4645,311,8723,142,686,431,915,289,229,1036,66181,1.262008733624454,368.73025370858846
4646,265,8723,252,813,554,1196,302,383,1370,115666,0.7885117493472585,487.7427600692808
4647,1685,8723,105,693,503,1181,398,488,1772,194224,0.8155737704918032,629.7205729527979
4648,261,8723,123,686,493,1178,370,492,1724,182040,0.7520325203252033,615.6005198178442
4649,213,8723,44,689,557,1197,513,508,2042,260604,1.0098425196850394,721.9646805765501
4650,29,8374,176,687,759,1190,583,503,2172,293249,1.1590457256461233,769.9987012976061
4651,421,8374,44,613,857,1274,813,661,2948,537393,1.2299546142208777,1047.8024622990729
4652,405,8374,34,594,888,1300,854,706,3120,602924,1.2096317280453257,1108.0397104797282
4653,828,35360,48,393,550,640,502,247,1498,123994,2.0323886639676108,559.475647369928
4654,316,35360,21,332,543,659,522,327,1698,170694,1.5963302752293578,615.9650964137497
4655,495,35360,81,370,573,657,492,287,1558,141204,1.7142857142857142,569.590203567442
4656,32,34212,151,909,790,1189,639,280,1838,178920,2.282142857142857,697.6539256680206
4657,642,34212,190,786,855,1193,665,407,2144,270655,1.6339066339066342,779.6627476030902
4658,759,34212,176,704,921,1199,745,495,2480,368775,1.5050505050505047,894.4551414129162
4659,559,5169,61,769,183,842,122,73,390,8906,1.6712328767123288,142.1724305201258
4660,886,5169,32,761,185,844,153,83,472,12699,1.843373493975904,174.06320691059327
4661,567,5169,46,763,170,825,124,62,372,7688,2.0,138.63621460498698
4662,1571,10477,75,726,120,780,45,54,198,2430,0.8333333333333334,70.2922470831599
4663,255,10477,51,726,121,780,70,54,248,3780,1.2962962962962965,88.40814442120137
4664,805,10477,40,723,121,778,81,55,272,4455,1.4727272727272729,97.9081201943945
4665,1023,137,86,724,781,1194,695,470,2330,326650,1.4787234042553192,839.00238378684
4666,436,137,59,731,781,1192,722,461,2366,332842,1.5661605206073752,856.6241883113038
4667,1508,137,73,742,765,1192,692,450,2284,311400,1.5377777777777777,825.447757280859
4668,119,910,88,720,450,1011,362,291,1306,105342,1.243986254295533,464.4620544242554
4669,1413,910,265,706,382,926,117,220,674,25740,0.5318181818181819,249.1766441703556
4670,1602,910,62,695,438,1062,376,367,1486,137992,1.0245231607629428,525.4188805134432
4671,1607,910,73,694,423,1065,350,371,1442,129850,0.9433962264150944,510.0401944945124
4672,886,910,51,690,391,1058,340,368,1416,125120,0.9239130434782608,501.02295356600183
4673,1304,34362,189,219,459,607,270,388,1316,104760,0.6958762886597938,472.69863549623244
4674,1155,34362,201,229,441,522,240,293,1066,70320,0.8191126279863481,378.74661714660897
4675,1296,34362,211,235,421,564,210,329,1078,69090,0.6382978723404256,390.3088520646182
4676,1523,34362,152,243,507,599,355,356,1422,126380,0.9971910112359552,502.7534186855421
4677,308,34362,13,187,581,614,568,427,1990,242536,1.3302107728337236,710.6004503235274
4678,1097,34362,153,191,429,594,276,403,1358,111228,0.684863523573201,488.4516352721117
4679,918,34362,171,211,438,606,267,395,1324,105465,0.6759493670886076,476.77457985928737
4680,663,34362,100,185,541,597,441,412,1706,181692,1.0703883495145632,603.5105632878351
4681,541,34362,214,237,373,372,159,135,588,21465,1.1777777777777778,208.58091954922435
4682,1107,10598,95,494,505,955,410,461,1742,189010,0.8893709327548807,616.9448921905424
4683,1600,10598,114,557,468,931,354,374,1456,132396,0.9465240641711229,514.9679601683973
4684,1599,10598,211,567,483,852,272,285,1114,77520,0.9543859649122808,393.96573455060786
4685,1326,10598,176,515,497,692,321,177,996,56817,1.8135593220338984,366.56513745854227
4686,786,10598,109,517,520,821,411,304,1430,124944,1.3519736842105263,511.211306604226
4687,1470,10598,116,507,481,977,365,470,1670,171550,0.7765957446808509,595.0840276801251
4688,1636,20259,216,1077,619,1412,403,335,1476,135005,1.2029850746268658,524.0553405891404
4689,1362,20259,258,1081,514,1335,256,254,1020,65024,1.0078740157480317,360.6272313622475
4690,174,20259,162,1041,633,1415,471,374,1690,176154,1.2593582887700534,601.4291313197258
4691,1480,20259,134,1041,650,1398,516,357,1746,184212,1.4453781512605042,627.4591620177364
4692,1321,20259,157,1022,647,1412,490,390,1760,191100,1.2564102564102564,626.2587324740471
4693,1508,168,108,483,439,1216,331,733,2128,242623,0.451568894952251,804.2698552103019
4694,1383,168,118,472,446,1203,328,731,2118,239768,0.4487004103967168,801.214702810676
4695,1023,168,98,516,433,1154,335,638,1946,213730,0.5250783699059561,720.6032195320806
4696,254,18120,81,965,214,1019,133,54,374,7182,2.462962962962963,143.54441821262157
4697,246,18120,75,962,225,1025,150,63,426,9450,2.380952380952381,162.69296235547498
4698,1147,18120,74,955,213,1025,139,70,418,9730,1.9857142857142855,155.63097378092831
4699,1302,19846,109,363,606,798,497,435,1864,216195,1.1425287356321838,660.4801283914604
4700,496,19846,109,368,618,760,509,392,1802,199528,1.298469387755102,642.4523328621353
4701,263,19846,108,382,680,907,572,525,2194,300300,1.0895238095238096,776.407753696471
4702,1212,19846,225,460,705,801,480,341,1642,163680,1.4076246334310851,588.7962296074933
4703,1158,19846,42,346,622,809,580,463,2086,268540,1.2526997840172789,742.1381273051534
4704,49,19846,135,404,736,832,601,428,2058,257228,1.4042056074766356,737.8245048790396
4705,309,19846,33,366,732,791,699,425,2248,297075,1.6447058823529412,818.0623448124232
4706,1623,19846,140,349,618,847,478,498,1952,238044,0.9598393574297188,690.2811021605619
4707,1383,13438,47,1043,536,1401,489,358,1694,175062,1.3659217877094971,606.0404276943907
4708,1389,13438,45,1063,264,1404,219,341,1120,74679,0.6422287390029325,405.26781268687006
4709,306,13438,286,1044,543,1398,257,354,1222,90978,0.7259887005649718,437.4528546026417
4710,909,13438,373,1068,524,1363,151,295,892,44545,0.511864406779661,331.40006035002466
4711,650,13438,75,1039,526,1399,451,360,1622,162360,1.2527777777777778,577.0623883082313
4712,1382,13438,72,1043,539,1401,467,358,1650,167186,1.3044692737430168,588.4326639472014
4713,1241,13438,95,1073,251,1393,156,320,952,49920,0.4875,356.0
4714,105,29906,61,942,179,1030,118,88,412,10384,1.3409090909090908,147.20054347725758
4715,1295,29906,59,944,181,1034,122,90,424,10980,1.3555555555555556,151.6047492659778
4716,161,29906,62,944,185,1036,123,92,430,11316,1.3369565217391304,153.60013020827813
4717,1748,29906,63,946,168,1035,105,89,388,9345,1.1797752808988764,137.64446955835166
4718,831,29906,69,965,166,1041,97,76,346,7372,1.2763157894736843,123.22743201089601
4719,1219,10255,53,1082,76,1098,23,16,78,368,1.4375,28.0178514522438
4720,886,10255,54,1087,60,1096,6,9,30,54,0.6666666666666666,10.816653826391969
4721,283,10255,53,1086,60,1097,7,11,36,77,0.6363636363636364,13.038404810405298
4722,3,10255,55,1084,61,1097,6,13,38,78,0.4615384615384616,14.317821063276353
4723,1599,10255,53,1082,78,1098,25,16,82,400,1.5625,29.68164415931166
4724,1470,10255,53,1083,77,1097,24,14,76,336,1.7142857142857142,27.784887978899608
4725,1600,10255,54,1086,64,1099,10,13,46,130,0.7692307692307693,16.401219466856727
4726,786,10255,56,1082,76,1097,20,15,70,300,1.3333333333333333,25.0
4728,392,10255,55,1082,77,1098,22,16,76,352,1.375,27.202941017470888
4729,782,10255,54,1084,63,1098,9,14,46,126,0.6428571428571429,16.64331697709324
4730,1696,10255,54,1085,63,1099,9,14,46,126,0.6428571428571429,16.64331697709324
4731,1326,10255,54,1082,77,1096,23,14,74,322,1.6428571428571428,26.92582403567252
4732,615,35131,172,534,872,1047,700,513,2426,359100,1.364522417153996,867.8530981681174
4733,1704,35131,24,519,929,1129,905,610,3030,552050,1.4836065573770492,1091.386732556338
4734,169,35131,215,530,843,1073,628,543,2342,341004,1.156537753222836,830.2005781737327
4735,1045,4322,27,358,55,379,28,21,98,588,1.3333333333333333,35.0
4736,1371,4322,24,357,54,382,30,25,110,750,1.2,39.05124837953327
4737,615,4322,29,358,61,377,32,19,102,608,1.6842105263157894,37.21558813185679
4738,1635,4322,27,356,61,379,34,23,114,782,1.4782608695652173,41.048751503547585
4739,401,4322,23,358,58,383,35,25,120,875,1.4,43.01162633521314
4740,462,4322,35,366,48,376,13,10,46,130,1.3,16.401219466856727
4741,498,9663,114,598,370,863,256,265,1042,67840,0.9660377358490566,368.45759593201495
4742,1210,9663,83,599,367,861,284,262,1092,74408,1.083969465648855,386.39358172723314
4743,1588,9663,100,614,365,851,265,237,1004,62805,1.1181434599156117,355.51933843322786
4744,1300,9663,71,598,233,877,162,279,882,45198,0.5806451612903226,322.62206992082855
4745,1580,9663,100,618,438,883,338,265,1206,89570,1.2754716981132077,429.49854481709247
4746,261,9663,122,626,217,706,95,80,350,7600,1.1875,124.19742348374221
4747,1557,20852,84,668,710,1117,626,449,2150,281074,1.3942093541202674,770.374584212122
4748,593,20852,78,651,725,1166,647,515,2324,333205,1.2563106796116503,826.9425614877977
4749,592,20852,95,660,710,1159,615,499,2228,306885,1.2324649298597194,791.9760097376687
4750,1186,34934,37,546,389,1172,352,626,1956,220352,0.5623003194888179,718.1782508542012
4751,20,34934,48,570,423,1182,375,612,1974,229500,0.6127450980392157,717.7527429414673
4752,345,34934,78,588,435,1159,357,571,1856,203847,0.6252189141856392,673.4166615105391
4753,1361,7673,122,981,380,1180,258,199,914,51342,1.2964824120603016,325.8297101247828
4754,1149,7673,122,990,359,1197,237,207,888,49059,1.144927536231884,314.67125702866474
4755,712,7673,130,986,332,1194,202,208,820,42016,0.971153846153846,289.9448223369405
4756,1628,7673,134,1002,335,1201,201,199,800,39999,1.0100502512562817,282.8462479864281
4757,1744,7673,94,972,352,1219,258,247,1010,63726,1.0445344129554657,357.17362724590964
4758,166,7673,84,964,144,981,60,17,154,1020,3.5294117647058822,62.36184731067546
4759,875,7673,122,1017,339,1163,217,146,726,31682,1.4863013698630136,261.5434954266689
4760,161,7673,91,975,349,1194,258,219,954,56502,1.178082191780822,338.4154251803543
4761,102,7673,119,998,345,1185,226,187,826,42262,1.2085561497326205,293.33428030150174
4762,158,7673,170,1025,331,1139,161,114,550,18354,1.4122807017543861,197.27392123643713
4763,1117,16236,61,937,283,1138,222,201,846,44622,1.1044776119402986,299.47453981933086
4764,835,16236,65,927,283,1208,218,281,998,61258,0.7758007117437722,355.64729719203547
4765,58,16236,78,944,279,1187,201,243,888,48843,0.8271604938271605,315.35694062442957
4766,924,1147,45,674,105,738,60,64,248,3840,0.9375,87.72684879784524
4767,886,1147,38,656,168,735,130,79,418,10270,1.6455696202531649,152.12166183683374
4768,1225,1147,39,654,169,740,130,86,432,11180,1.5116279069767442,155.8717421471897
4769,1602,1147,52,659,153,729,101,70,342,7070,1.4428571428571428,122.88612614937456
4770,1103,1147,38,654,169,731,131,77,416,10087,1.7012987012987013,151.95394038984313
4771,880,1147,37,653,168,742,131,89,440,11659,1.4719101123595506,158.3729774930054
4772,1101,1147,38,668,168,740,130,72,404,9360,1.805555555555556,148.60686390607938
4773,891,18371,51,889,352,1125,301,236,1074,71036,1.2754237288135593,382.48790830560904
4774,1610,18371,74,947,292,1111,218,164,764,35752,1.329268292682927,272.80029325497435
4775,956,18371,93,941,204,1114,111,173,568,19203,0.6416184971098265,205.54804791094466
4776,78,18371,69,925,303,1104,234,179,826,41886,1.3072625698324023,294.61330587738223
4777,944,18371,80,962,302,1083,222,121,686,26862,1.834710743801653,252.83393759541065
4778,1429,18371,60,921,294,1104,234,183,834,42822,1.278688524590164,297.0605998782067
4779,240,18371,127,941,293,999,166,58,448,9628,2.862068965517241,175.84083712266613
4780,1463,9211,55,180,536,657,481,477,1916,229437,1.0083857442348008,677.4142012092749
4781,448,9211,87,259,534,653,447,394,1682,176118,1.134517766497462,595.8565263551285
4782,866,9211,30,215,549,699,519,484,2006,251196,1.072314049586777,709.6597776399618
4783,1206,28021,63,496,81,519,18,23,82,414,0.7826086956521741,29.206163733020468
4784,698,28021,61,494,77,509,16,15,62,240,1.0666666666666669,21.93171219946131
4785,1503,28021,64,495,82,508,18,13,62,234,1.3846153846153846,22.20360331117452
4786,818,28021,33,490,80,529,47,39,172,1833,1.205128205128205,61.07372593840988
4787,1442,28021,29,492,85,531,56,39,190,2184,1.4358974358974361,68.24221567329127
4788,1198,28021,42,493,83,522,41,29,140,1189,1.4137931034482758,50.21951811795888
4789,252,28021,37,497,80,526,43,29,144,1247,1.4827586206896552,51.86520991955976
4790,1400,26492,96,740,282,941,186,201,774,37386,0.9253731343283582,273.85580147223465
4791,1742,26492,65,729,363,987,298,258,1112,76884,1.1550387596899223,394.1674770957137
4792,831,26492,78,742,327,960,249,218,934,54282,1.1422018348623852,330.94561486745823
4793,1331,32928,31,846,42,855,11,9,40,99,1.2222222222222223,14.212670403551895
4794,957,32928,32,846,44,856,12,10,44,120,1.2,15.620499351813308
4795,952,32928,31,846,42,856,11,10,42,110,1.1,14.866068747318506
4796,128,32928,31,845,43,856,12,11,46,132,1.0909090909090908,16.278820596099706
4797,191,32928,32,848,41,854,9,6,30,54,1.5,10.816653826391969
4798,1548,32928,32,846,44,855,12,9,42,108,1.3333333333333333,15.0
4799,560,17190,67,942,225,1068,158,126,568,19908,1.2539682539682542,202.08908926510605
4800,451,17190,57,944,221,1072,164,128,584,20992,1.28125,208.0384579831335
4801,457,17190,147,968,218,1045,71,77,296,5467,0.9220779220779219,104.7377677822093
4802,737,17190,69,951,213,1068,144,117,522,16848,1.2307692307692308,185.53975315279473
4803,1531,17190,90,956,215,1066,125,110,470,13750,1.1363636363636365,166.50825805346713
4804,674,17190,96,969,215,1077,119,108,454,12852,1.101851851851852,160.70158679988197
4805,389,17190,73,948,222,1082,149,134,566,19966,1.111940298507463,200.39211561336438
4806,759,31641,59,453,877,1021,818,568,2772,464624,1.4401408450704225,995.8654527595583
4807,858,31641,28,424,885,1017,857,593,2900,508201,1.445193929173693,1042.160256390542
4808,1566,31641,81,443,805,1011,724,568,2584,411232,1.2746478873239435,920.2173656261873
4809,1074,18712,52,594,327,750,275,156,862,42900,1.7628205128205128,316.16609558901155
4810,699,18712,53,606,325,748,272,142,828,38624,1.9154929577464788,306.8354607929142
4811,297,18712,36,616,345,789,309,173,964,53457,1.786127167630058,354.13274347340433
4812,857,3146,166,764,645,1267,479,503,1964,240937,0.952286282306163,694.5862077525006
4813,1383,3146,170,774,690,1275,520,501,2042,260520,1.037924151696607,722.0810203848318
4814,903,3146,84,766,674,1183,590,417,2014,246030,1.4148681055155876,722.4880621851132
4815,831,28998,41,690,1033,1294,992,604,3192,599168,1.6423841059602649,1161.412932595466
4816,105,28998,479,652,1037,1286,558,634,2384,353772,0.8801261829652997,844.5827372140636
4817,1295,28998,380,715,1027,1290,647,575,2444,372025,1.1252173913043475,865.5830404992926
4818,699,18750,67,217,573,612,506,395,1802,199870,1.281012658227848,641.9197769192035
4819,1728,18750,47,218,578,645,531,427,1916,226737,1.2435597189695549,681.3882887164997
4820,297,18750,20,207,544,652,524,445,1938,233180,1.1775280898876404,687.4598170075107
4821,455,32701,245,546,763,1011,518,465,1966,240870,1.113978494623656,696.0955394196977
4822,453,32701,381,635,806,964,425,329,1508,139825,1.2917933130699089,537.4625568353576
4823,669,32701,126,505,792,1037,666,532,2396,354312,1.2518796992481205,852.3966212978556
4824,1046,32701,224,570,743,936,519,366,1770,189954,1.4180327868852458,635.0724368133134
4825,884,32701,139,525,801,1001,662,476,2276,315112,1.3907563025210083,815.3649489645726
4826,937,32701,171,483,560,542,389,59,896,22951,6.59322033898305,393.4488530927495
4827,515,32701,69,472,795,1015,726,543,2538,394218,1.3370165745856353,906.6007941756945
4828,1596,32701,98,513,798,988,700,475,2350,332500,1.4736842105263157,845.9462157844315
4829,1528,32701,380,612,773,952,393,340,1466,133620,1.1558823529411764,519.6623904036157
4830,258,33434,104,340,377,797,273,457,1460,124761,0.5973741794310722,532.3326027964096
4831,32,33434,86,395,471,786,385,391,1552,150535,0.9846547314578004,548.7312639170472
4832,858,33434,32,325,463,876,431,551,1964,237481,0.7822141560798548,699.5441372779848
4833,648,33434,93,318,458,815,365,497,1724,181405,0.7344064386317908,616.6311701495473
4834,759,33434,27,311,481,887,454,576,2060,261504,0.7881944444444444,733.411207986352
4835,1505,33434,142,363,384,768,242,405,1294,98010,0.5975308641975309,471.79338698205595
4836,387,14574,46,1189,364,1523,318,334,1304,106212,0.9520958083832336,461.17241894978935
4837,792,14574,123,1222,373,1505,250,283,1066,70750,0.8833922261484098,377.6095867427097
4838,1370,14574,35,1165,387,1514,352,349,1402,122848,1.008595988538682,495.68639279286253
4839,391,13209,58,761,151,920,93,159,504,14787,0.5849056603773585,184.20097719610501
4840,1107,13209,49,778,142,900,93,122,430,11346,0.7622950819672131,153.40469353966978
4841,1046,13209,46,772,152,919,106,147,506,15582,0.7210884353741497,181.23189564753773
4842,676,13209,70,767,128,879,58,112,340,6496,0.5178571428571429,126.1269202034205
4843,1037,13209,61,797,62,798,1,1,4,1,1.0,1.4142135623730951
4844,282,13209,40,770,147,911,107,141,496,15087,0.7588652482269503,177.00282483621552
4845,1170,13209,49,769,149,903,100,134,468,13400,0.746268656716418,167.20047846821492
4846,1417,13209,63,761,143,892,80,131,422,10480,0.6106870229007634,153.4959282847594
4847,848,20311,523,1244,732,1429,209,185,788,38665,1.1297297297297295,279.1164631475542
4848,351,20311,463,1322,561,1394,98,72,340,7056,1.3611111111111112,121.60592090848209
4849,71,20311,146,1160,752,1600,606,440,2092,266640,1.3772727272727272,748.8898450373059
4850,30,20311,553,1189,737,1447,184,258,884,47472,0.7131782945736435,316.8911485037094
4851,852,20311,60,1160,752,1591,692,431,2246,298252,1.6055684454756383,815.2453618389987
4852,854,20311,163,1096,695,1644,532,548,2160,291536,0.9708029197080292,763.759124331749
4853,234,20311,503,1124,759,1482,256,358,1228,91648,0.7150837988826816,440.1136216933077
4854,523,20311,84,1096,699,1623,615,527,2284,324105,1.1669829222011383,809.9098715289251
4855,476,20311,38,1184,748,1644,710,460,2340,326600,1.5434782608695652,845.9905436823748
4856,411,29780,41,1199,605,1737,564,538,2204,303432,1.0483271375464684,779.4485229955857
4857,852,29780,59,1193,641,1749,582,556,2276,323592,1.0467625899280577,804.8975090034755
4858,744,29780,66,1200,594,1743,528,543,2142,286704,0.9723756906077348,757.3856349311096
4859,1012,20028,49,355,533,674,484,319,1606,154396,1.5172413793103448,579.6697335552375
4860,1335,20028,170,407,314,584,144,177,642,25488,0.8135593220338984,228.17756243767704
4861,1717,20028,101,396,539,587,438,191,1258,83658,2.2931937172774868,477.83365306349026
4862,1614,20028,108,358,532,652,424,294,1436,124656,1.4421768707482994,515.9573625795061
4863,473,20028,36,355,38,357,2,2,8,4,1.0,2.8284271247461903
4864,1281,20028,95,364,538,606,443,242,1370,107206,1.8305785123966944,504.79005536955657
4865,217,22483,37,768,40,770,3,2,10,6,1.5,3.605551275463989
4866,110,22483,37,768,40,770,3,2,10,6,1.5,3.605551275463989
4867,1595,22483,38,768,39,769,1,1,4,1,1.0,1.4142135623730951
4868,1470,22483,37,768,38,769,1,1,4,1,1.0,1.4142135623730951
4869,1408,22483,37,768,40,770,3,2,10,6,1.5,3.605551275463989
4870,1222,22483,38,768,39,769,1,1,4,1,1.0,1.4142135623730951
4871,1393,4788,144,926,862,1457,718,531,2498,381258,1.3521657250470809,893.0201565474321
4872,1389,4788,142,921,893,1451,751,530,2562,398030,1.4169811320754715,919.1849650641594
4873,819,4788,98,948,860,1450,762,502,2528,382524,1.5179282868525896,912.4954794408573
4874,294,4788,214,974,827,1425,613,451,2128,276463,1.35920177383592,761.0321937999732
4875,1021,4788,114,852,819,1481,705,629,2668,443445,1.1208267090620032,944.8100338163223
4876,1549,22992,61,977,689,1274,628,297,1850,186516,2.114478114478114,694.6891391118764
4877,27,22992,75,989,289,1258,214,269,966,57566,0.7955390334572491,343.7397271192261
4878,952,22992,156,1063,261,1243,105,180,570,18900,0.5833333333333334,208.38665984174708
4879,576,22992,110,946,618,1246,508,300,1616,152400,1.6933333333333334,589.9694907365973
4880,636,22992,66,1000,707,1278,641,278,1838,178198,2.305755395683453,698.6880562883554
4881,1182,22992,94,1025,277,1213,183,188,742,34404,0.9734042553191491,262.36043909095747
4882,752,22992,60,880,709,1297,649,417,2132,270633,1.5563549160671464,771.4207671562907
4883,388,8506,371,431,388,437,17,6,46,102,2.833333333333333,18.027756377319946
4884,387,8506,138,350,810,1233,672,883,3110,593376,0.7610419026047565,1109.627414946116
4885,1479,8506,138,423,750,1252,612,829,2882,507348,0.7382388419782869,1030.4295220926078
4886,178,8506,79,358,827,1173,748,815,3126,609620,0.9177914110429448,1106.22285277425
4887,1319,8506,226,428,909,1214,683,786,2938,536838,0.8689567430025446,1041.2900652555943
4888,401,8506,147,401,872,1190,725,789,3028,572025,0.9188846641318124,1071.5157488343323
4889,1698,8506,224,360,739,966,515,606,2242,312090,0.8498349834983498,795.2741665614444
4890,1585,28183,179,418,658,1018,479,600,2158,287400,0.7983333333333333,767.7506105500665
4891,153,28183,180,454,589,962,409,508,1834,207772,0.8051181102362205,652.1847897643735
4892,266,28183,90,329,611,1072,521,743,2528,387103,0.7012113055181696,907.4634978884826
4893,310,28183,173,369,506,1001,333,632,1930,210456,0.5268987341772152,714.3619530742101
4894,917,28183,143,307,500,1020,357,713,2140,254541,0.5007012622720898,797.3819661868457
4895,1458,28183,134,414,521,995,387,581,1936,224847,0.6660929432013769,698.0902520448197
4896,46,32866,85,409,235,486,150,77,454,11550,1.9480519480519483,168.60901518009052
4897,1361,32866,45,408,244,515,199,107,612,21293,1.8598130841121496,225.94247055390008
4898,1513,32866,41,382,247,527,206,145,702,29870,1.4206896551724135,251.91466809219347
4899,1679,32866,41,394,235,497,194,103,594,19982,1.883495145631068,219.64744478368056
4900,874,32866,95,388,243,497,148,109,514,16132,1.3577981651376148,183.8069639594757
4901,656,32866,66,396,242,508,176,112,576,19712,1.5714285714285714,208.61447696648477
4902,178,30097,194,119,769,750,575,631,2412,362825,0.9112519809825672,853.689639154652
4903,886,30097,291,121,705,766,414,645,2118,267030,0.6418604651162789,766.43395018749
4904,1225,30097,236,128,727,700,491,572,2126,280852,0.8583916083916084,753.833536001152
4905,1481,16332,44,620,405,872,361,252,1226,90972,1.4325396825396826,440.25560757360034
4906,991,16332,124,719,330,749,206,30,472,6180,6.866666666666666,208.1730049742281
4907,1267,16332,62,659,354,853,292,194,972,56648,1.5051546391752575,350.5709628591621
4908,1596,32764,141,753,328,915,187,162,698,30294,1.154320987654321,247.41261083461367
4909,455,32764,129,726,296,904,167,178,690,29726,0.9382022471910112,244.07580789582568
4910,1046,32764,121,773,326,869,205,96,602,19680,2.1354166666666665,226.3647499059869
4911,1270,32764,147,775,346,866,199,91,580,18109,2.1868131868131866,218.81956036881164
4912,884,32764,121,729,338,916,217,187,808,40579,1.1604278074866308,286.457675756821
4913,1601,2901,126,741,197,847,71,106,354,7526,0.6698113207547169,127.58134659894448
4914,1116,2901,70,684,678,994,608,310,1836,188480,1.961290322580645,682.4690469171477
4915,1262,2901,74,661,670,1024,596,363,1918,216348,1.6418732782369143,697.8431055760313
4916,1107,2901,216,684,477,907,261,223,968,58203,1.1704035874439462,343.29287787543745
4917,787,2901,141,735,485,885,344,150,988,51600,2.293333333333333,375.2812278811718
4918,1220,2901,72,651,669,716,597,65,1324,38805,9.184615384615384,600.5281009245113
4919,1526,2901,97,685,680,930,583,245,1656,142835,2.379591836734694,632.3875394091822
4920,455,2901,102,667,624,965,522,298,1640,155556,1.751677852348993,601.0723750098651
4921,1317,2901,122,704,660,976,538,272,1620,146336,1.9779411764705883,602.8498983992615
4922,1513,32626,166,323,722,885,556,562,2236,312472,0.98932384341637,790.5567658302597
4923,1351,32626,266,407,461,666,195,259,908,50505,0.752895752895753,324.20055521235616
4924,1634,32626,204,365,653,879,449,514,1926,230786,0.8735408560311284,682.4932234095809
4925,46,32626,234,390,686,784,452,394,1692,178088,1.1472081218274113,599.6165441346661
4926,874,32626,456,547,680,775,224,228,904,51072,0.9824561403508772,319.62478001556764
4927,656,32626,434,542,765,741,331,199,1060,65869,1.6633165829145728,386.21496604870197
4928,1138,28096,37,439,144,540,107,101,416,10807,1.0594059405940597,147.13938969562162
4929,1348,28096,54,436,143,543,89,107,392,9523,0.8317757009345794,139.17614738165446
4930,764,28096,27,435,143,542,116,107,446,12412,1.0841121495327102,157.8131806916013
4931,1558,19200,31,457,411,718,380,261,1282,99180,1.4559386973180075,461.0
4932,1504,19200,216,541,392,620,176,79,510,13904,2.2278481012658227,192.91708063310517
4933,1503,19200,30,466,382,718,352,252,1208,88704,1.3968253968253967,432.90645640831
4934,1663,19200,24,437,409,711,385,274,1318,105490,1.405109489051095,472.547352124631
4935,1339,19200,284,528,371,663,87,135,444,11745,0.6444444444444445,160.60510577189007
4936,763,19200,28,454,446,724,418,270,1376,112860,1.548148148148148,497.61832763675415
4937,296,19200,31,431,439,723,408,292,1400,119136,1.3972602739726028,501.7250242911948
4938,1722,19200,131,447,437,703,306,256,1124,78336,1.1953125,398.9636574927596
4939,128,32106,47,689,589,932,542,243,1570,131706,2.230452674897119,593.9806394151244
4940,191,32106,108,697,550,905,442,208,1300,91936,2.125,488.4956499294543
4941,465,32106,95,566,281,682,186,116,604,21576,1.6034482758620692,219.20766409959302
4942,1281,32106,29,676,589,896,560,220,1560,123200,2.5454545454545454,601.6643582596529
4943,957,32106,112,675,559,953,447,278,1450,124266,1.6079136690647482,526.396238588385
4944,391,30683,46,1224,121,1274,75,50,250,3750,1.5,90.13878188659973
4945,118,30683,45,1222,117,1273,72,51,246,3672,1.4117647058823528,88.23264701911646
4946,1046,30683,58,1239,91,1259,33,20,106,660,1.65,38.58756276314948
4947,926,30683,45,1223,121,1273,76,50,252,3800,1.52,90.97252332435328
4948,886,30683,47,1223,120,1273,73,50,246,3650,1.46,88.48163651289458
4949,1476,21231,41,747,426,1059,385,312,1394,120120,1.2339743589743593,495.54919029295166
4950,1272,21231,62,717,438,1061,376,344,1440,129344,1.0930232558139534,509.61946587625556
4951,1219,21231,42,686,410,1063,368,377,1490,138736,0.9761273209549072,526.8329906146729
4952,1702,21231,129,704,422,1019,293,315,1216,92295,0.9301587301587302,430.20227800419656
4953,2,21231,53,746,327,1026,274,280,1108,76720,0.9785714285714284,391.76013069223876
4954,74,8288,148,526,372,750,224,224,896,50176,1.0,316.7838379715733
4955,1661,8288,133,471,365,696,232,225,914,52200,1.0311111111111109,323.1857051294194
4956,25,8288,179,518,315,692,136,174,620,23664,0.7816091954022989,220.8438362282271
4957,124,8288,107,490,372,781,265,291,1112,77115,0.9106529209621992,393.58099547615353
4958,1373,8288,139,499,349,722,210,223,866,46830,0.9417040358744396,306.31519714176767
4959,421,8288,132,500,339,780,207,280,974,57960,0.7392857142857143,348.20827101032506
4960,886,10058,68,894,88,925,20,31,102,620,0.6451612903225806,36.89173349139343
4961,453,10058,67,897,91,915,24,18,84,432,1.3333333333333333,30.0
4962,1219,10058,68,896,91,923,23,27,100,621,0.8518518518518519,35.4682957019364
4963,969,5604,443,457,674,831,231,374,1210,86394,0.6176470588235294,439.5873064591379
4964,1508,5604,24,348,318,911,294,563,1714,165522,0.522202486678508,635.1417164696395
4965,819,5604,26,355,925,1009,899,654,3106,587946,1.374617737003058,1111.7180397924647
4966,1137,5604,71,343,922,1017,851,674,3050,573574,1.2626112759643917,1085.576805205417
4967,1065,5604,385,629,519,793,134,164,596,21976,0.8170731707317073,211.7829077144801
4968,701,5604,28,349,809,850,781,501,2564,391281,1.5588822355289418,927.8803802215025
4969,1574,5604,103,349,819,910,716,561,2554,401676,1.2762923351158646,909.6026605062234
4970,1021,5604,15,342,911,1008,896,666,3124,596736,1.3453453453453454,1116.410318834433
4971,137,5604,36,343,923,1016,887,673,3120,596951,1.3179791976225854,1113.4172623055563
4972,809,5604,38,375,923,1008,885,633,3036,560205,1.3981042654028435,1088.0781221952768
4973,768,17419,41,742,213,858,172,116,576,19952,1.4827586206896552,207.46083967823904
4974,770,17419,93,741,184,829,91,88,358,8008,1.0340909090909092,126.58988901172162
4975,1684,17419,49,745,203,846,154,101,510,15554,1.5247524752475248,184.16568627190028
4976,1592,17419,122,754,185,840,63,86,298,5418,0.7325581395348837,106.60675400742676
4977,1266,9180,76,757,342,943,266,186,904,49476,1.4301075268817205,324.57972826410463
4978,1047,9180,54,728,379,1005,325,277,1204,90025,1.1732851985559567,427.029273001278
4979,1597,9180,39,729,404,976,365,247,1224,90155,1.4777327935222673,440.7198656743306
4980,387,9180,46,727,391,1015,345,288,1266,99360,1.1979166666666667,449.40961271428097
4981,1319,9180,58,737,414,1020,356,283,1278,100748,1.2579505300353355,454.78016667396565
4982,386,9180,149,800,315,892,166,92,516,15272,1.8043478260869563,189.7893569197177
4983,886,30796,193,756,583,1152,390,396,1572,154440,0.9848484848484848,555.8021230617961
4984,1706,30796,93,761,579,1153,486,392,1756,190512,1.239795918367347,624.3877000710376
4985,998,30796,102,767,575,1158,473,391,1728,184943,1.2097186700767264,613.6855872513221
4986,831,35868,63,607,314,766,251,159,820,39909,1.578616352201258,297.122870206923
4987,555,35868,164,631,323,780,159,149,616,23691,1.0671140939597314,217.90364843205356
4988,1684,35868,92,610,312,783,220,173,786,38060,1.2716763005780347,279.8731855680354
4989,1750,35868,77,609,320,757,243,148,782,35964,1.641891891891892,284.5224068504975
4990,1359,35868,76,609,317,795,241,186,854,44826,1.2956989247311828,304.4289736539543
4991,984,35868,80,605,316,783,236,178,828,42008,1.3258426966292134,295.6010825419961
4992,1243,35868,72,602,314,806,242,204,892,49368,1.1862745098039216,316.51224304914336
4993,1585,35868,151,637,313,787,162,150,624,24300,1.08,220.78043391568917
4994,514,9880,191,253,425,567,234,314,1096,73476,0.7452229299363057,391.60183860651114
4995,392,9880,187,336,331,492,144,156,600,22464,0.9230769230769232,212.30167215544958
4996,886,9880,165,284,416,570,251,286,1074,71786,0.8776223776223776,380.5220098759072
4997,1536,9880,167,286,446,641,279,355,1268,99045,0.7859154929577464,451.5152267642809
4998,1599,9880,144,254,442,585,298,331,1258,98638,0.9003021148036254,445.3818586336898
4999,326,9880,80,255,429,763,349,508,1714,177292,0.6870078740157479,616.3318911106255
5000,66,9880,170,318,431,592,261,274,1070,71514,0.9525547445255474,378.41379467455994
5001,783,9880,167,289,438,622,271,333,1208,90243,0.8138138138138138,429.3366977093852
5002,1686,511,56,789,207,919,151,130,562,19630,1.1615384615384616,199.25109786397664
5003,555,511,96,785,206,924,110,139,498,15290,0.7913669064748201,177.2596964907703
5004,1750,511,74,794,215,904,141,110,502,15510,1.2818181818181815,178.83232370016333
5005,1359,511,60,798,210,915,150,117,534,17550,1.2820512820512822,190.23406634985227
5006,1633,511,48,786,223,924,175,138,626,24150,1.2681159420289856,222.86543024883872
5007,984,511,78,792,221,924,143,132,550,18876,1.0833333333333333,194.60986614249546
5008,1694,511,80,782,203,923,123,141,528,17343,0.8723404255319149,187.1095935541521
5009,607,511,146,798,147,799,1,1,4,1,1.0,1.4142135623730951
5010,656,26760,154,463,829,937,675,474,2298,319950,1.4240506329113924,824.8036129891769
5011,66,26760,73,444,875,982,802,538,2680,431476,1.4907063197026025,965.7370242462489
5012,1030,26760,564,599,884,912,320,313,1266,100160,1.022364217252396,447.6259599263653
5013,379,26760,119,599,861,962,742,363,2210,269346,2.044077134986226,826.0345029113494
5014,1154,26760,272,441,906,955,634,514,2296,325876,1.233463035019455,816.1813523966349
5015,1150,26760,137,475,909,1001,772,526,2596,406072,1.467680608365019,934.1627267237759
5016,61,26760,390,464,677,671,287,207,988,59409,1.3864734299516908,353.86155484878543
5017,1085,26760,112,609,900,971,788,362,2300,285256,2.176795580110497,867.1724165354892
5018,885,26760,249,443,890,951,641,508,2298,325628,1.2618110236220472,817.8905794786978
5019,932,28594,121,918,600,1274,479,356,1670,170524,1.345505617977528,596.8056635120012
5020,1319,28594,223,926,546,1356,323,430,1506,138890,0.7511627906976744,537.8001487541632
5021,1225,28594,38,913,580,1325,542,412,1908,223304,1.3155339805825244,680.8142184179176
5022,362,7481,24,516,69,567,45,51,192,2295,0.8823529411764706,68.01470429252781
5023,1389,7481,19,518,72,572,53,54,214,2862,0.9814814814814816,75.66372975210778
5024,1442,7481,26,521,91,566,65,45,220,2925,1.4444444444444444,79.05694150420949
5025,1508,7481,19,519,37,573,18,54,144,972,0.3333333333333333,56.92099788303083
5026,768,17449,63,901,187,1159,124,258,764,31992,0.4806201550387597,286.2516375499012
5027,1592,17449,38,915,180,1112,142,197,678,27974,0.7208121827411168,242.84357104934855
5028,1684,17449,52,907,226,1149,174,242,832,42108,0.71900826446281,298.0603965641863
5029,1565,78,75,224,590,707,515,483,1996,248745,1.0662525879917184,706.0552386322192
5030,1508,78,99,197,587,705,488,508,1992,247904,0.9606299212598424,704.4203290649696
5031,903,78,49,194,617,652,568,458,2052,260144,1.240174672489083,729.6492307951814
5032,1573,78,120,204,575,707,455,503,1916,228865,0.9045725646123258,678.2580629819302
5033,711,19666,444,222,586,435,142,213,710,30246,0.6666666666666666,255.99414055794324
5034,1210,19666,272,124,769,677,497,553,2100,274841,0.8987341772151899,743.5173165434683
5035,379,19666,225,72,764,675,539,603,2284,325017,0.8938640132669984,808.7830364195332
5036,1248,19666,134,66,854,671,720,605,2650,435600,1.1900826446280992,940.4387274033328
5037,1006,2765,87,821,526,1098,439,277,1432,121603,1.584837545126354,519.0857347298229
5038,1651,2765,120,816,540,1117,420,301,1442,126420,1.3953488372093024,516.7213949508962
5039,889,2765,60,809,569,1148,509,339,1696,172551,1.5014749262536873,611.5570292294906
5040,1407,2891,167,803,847,1127,680,324,2008,220320,2.098765432098765,753.2436524790634
5041,1245,2891,108,768,733,1115,625,347,1944,216875,1.8011527377521614,714.8664210885835
5042,1033,2891,56,730,702,1180,646,450,2192,290700,1.4355555555555557,787.2839386142715
5043,335,3452,53,119,717,660,664,541,2410,359224,1.2273567467652495,856.4910974435169
5044,577,3452,28,107,828,667,800,560,2720,448000,1.4285714285714286,976.5244492586962
5045,1281,3452,31,105,828,685,797,580,2754,462260,1.3741379310344828,985.7022877116599
5046,1672,12695,229,283,759,803,530,520,2100,275600,1.0192307692307692,742.4957912338629
5047,1389,12695,333,285,746,803,413,518,1862,213934,0.7972972972972973,662.4899999245272
5048,1668,12695,301,285,770,731,469,446,1830,209174,1.0515695067264574,647.207076599136
5049,1513,32479,30,236,601,671,571,435,2012,248385,1.3126436781609196,717.8203117772581
5050,656,32479,11,215,597,683,586,468,2108,274248,1.252136752136752,749.9466647702355
5051,874,32479,66,236,608,634,542,398,1880,215716,1.3618090452261309,672.4343834159583
5052,1313,6736,53,486,179,609,126,123,498,15498,1.024390243902439,176.08236708995025
5053,561,6736,62,481,167,612,105,131,472,13755,0.8015267175572519,167.88686666919483
5054,789,6736,67,499,168,592,101,93,388,9393,1.0860215053763442,137.2953021774598
5055,891,18374,73,656,248,858,175,202,754,35350,0.8663366336633663,267.26204369494747
5056,956,18374,44,625,269,863,225,238,926,53550,0.9453781512605042,327.51946507039855
5057,78,18374,59,642,189,781,130,139,538,18070,0.9352517985611509,190.31815467789718
5058,1429,18374,35,546,457,860,422,314,1472,132508,1.3439490445859872,526.0038022676262
5059,569,18374,448,563,450,565,2,2,8,4,1.0,2.8284271247461903
5060,890,18374,36,550,453,861,417,311,1456,129687,1.3408360128617365,520.2018838874
5061,1720,18374,117,617,119,618,2,1,6,2,2.0,2.23606797749979
5062,1205,3589,93,733,188,808,95,75,340,7125,1.2666666666666666,121.03718436910205
5063,203,3589,61,730,177,819,116,89,410,10324,1.303370786516854,146.2087548678259
5064,858,3589,93,730,163,793,70,63,266,4410,1.1111111111111112,94.17536832951598
5065,1195,161,48,804,292,992,244,188,864,45872,1.2978723404255321,308.0259729308553
5066,1508,161,48,817,279,986,231,169,800,39039,1.366863905325444,286.22019495486336
5067,1023,161,81,810,287,980,206,170,752,35020,1.2117647058823529,267.0880004792428
5068,1323,26428,58,864,157,955,99,91,380,9009,1.0879120879120878,134.46932735757994
5069,1698,26428,61,861,152,955,91,94,370,8554,0.9680851063829788,130.83195328359201
5070,831,26428,38,791,274,951,236,160,792,37760,1.475,285.12453419514776
5071,379,26428,69,875,151,946,82,71,306,5822,1.1549295774647887,108.4665847162157
5072,1690,26428,63,868,171,961,108,93,402,10044,1.1612903225806452,142.52368224263643
5073,387,26428,62,851,155,957,93,106,398,9858,0.8773584905660378,141.01418368376991
5074,1470,10896,85,409,709,1247,624,838,2924,522912,0.7446300715990454,1044.8062021255425
5075,387,10896,151,355,660,1286,509,931,2880,473879,0.5467239527389903,1061.0570201454773
5076,1696,10896,183,425,734,1233,551,808,2718,445208,0.6819306930693071,977.9902862503287
5077,1319,9155,55,77,590,528,535,451,1972,241285,1.1862527716186253,699.7328061481754
5078,178,9155,177,82,489,404,312,322,1268,100464,0.968944099378882,448.361461323339
5079,387,9155,117,71,541,502,424,431,1710,182744,0.9837587006960556,604.5965596991105
5080,1585,1067,228,651,606,1085,378,434,1624,164052,0.8709677419354839,575.5345341506451
5081,604,1067,269,657,272,660,3,3,12,9,1.0,4.242640687119285
5082,1400,1067,239,653,654,924,415,271,1372,112465,1.5313653136531364,495.6470518423367
5083,607,1067,80,711,710,1070,630,359,1978,226170,1.7548746518105849,725.1075782254658
5084,1686,1067,217,646,666,1071,449,425,1748,190825,1.056470588235294,618.2442882874051
5085,577,3420,88,642,253,761,165,119,568,19635,1.3865546218487397,203.43549346168678
5086,407,3420,48,670,208,808,160,138,596,22080,1.1594202898550725,211.29126815843574
5087,464,3420,66,662,226,805,160,143,606,22880,1.1188811188811192,214.59030733003763
5088,886,30034,42,611,673,973,631,362,1986,228422,1.7430939226519335,727.4647757795562
5089,1370,30034,82,605,673,1026,591,421,2024,248811,1.4038004750593824,725.6183569894025
5090,119,30034,89,679,640,970,551,291,1684,160341,1.8934707903780068,623.122780838576
5091,886,5886,148,660,723,1109,575,449,2048,258175,1.2806236080178173,729.5382101028019
5092,389,5886,208,708,508,1047,300,339,1278,101700,0.8849557522123894,452.6820075947353
5093,559,5886,133,701,664,1064,531,363,1788,192753,1.4628099173553717,643.2184698840667
5094,32,34214,54,371,849,998,795,627,2844,498465,1.2679425837320577,1012.4988888882792
5095,1384,34214,22,362,836,1002,814,640,2908,520960,1.271875,1035.4689758751829
5096,759,34214,14,331,848,1017,834,686,3040,572124,1.2157434402332359,1079.885179081554
5097,1557,20859,267,530,887,891,620,361,1962,223820,1.7174515235457064,717.440589874869
5098,593,20859,227,451,917,903,690,452,2284,311880,1.5265486725663715,824.8660497317125
5099,761,20859,73,460,229,933,156,473,1258,73788,0.3298097251585624,498.06124121437114
5100,1508,20859,253,466,485,851,232,385,1234,89320,0.6025974025974026,449.49860956403415
5101,481,20859,352,443,707,935,355,492,1694,174660,0.7215447154471545,606.7033871670736
5102,479,20859,174,469,893,978,719,509,2456,365971,1.412573673870334,880.9324605212365
5103,900,20859,390,560,749,873,359,313,1344,112367,1.146964856230032,476.28772816439437
5104,136,20859,227,478,891,900,664,422,2172,280208,1.5734597156398105,786.7528201411164
5105,592,20859,276,492,877,899,601,407,2016,244607,1.4766584766584767,725.8443359288547
5106,426,20427,354,854,763,1136,409,282,1382,115338,1.4503546099290783,496.7947262199952
5107,592,20427,69,746,844,1250,775,504,2558,390600,1.5376984126984128,924.4679550963353
5108,1557,20427,165,807,845,1266,680,459,2278,312120,1.4814814814814814,820.4151388169284
5109,481,20427,535,798,538,801,3,3,12,9,1.0,4.242640687119285
5110,1145,20427,136,752,831,1272,695,520,2430,361400,1.3365384615384617,868.0005760366752
5111,865,20427,335,752,841,1267,506,515,2042,260590,0.9825242718446602,721.984071846464
5112,971,23060,50,478,361,631,311,153,928,47583,2.0326797385620914,346.5977495599185
5113,300,23060,35,472,359,653,324,181,1010,58644,1.7900552486187846,371.12935750220566
5114,438,23060,65,473,100,578,35,105,280,3675,0.3333333333333333,110.67971810589327
5115,140,23060,39,480,185,580,146,100,492,14600,1.46,176.96327302578916
5116,247,23060,130,494,150,513,20,19,78,380,1.0526315789473684,27.586228448267445
5117,1241,23060,56,505,118,589,62,84,292,5208,0.7380952380952381,104.4030650891055
5118,1500,23060,59,487,364,661,305,174,958,53070,1.7528735632183907,351.14242124813114
5119,592,23060,33,460,370,649,337,189,1052,63693,1.7830687830687832,386.38064133701107
5120,805,23060,43,533,96,568,53,35,176,1855,1.5142857142857142,63.51377803280167
5121,1508,23060,37,485,149,572,112,87,398,9744,1.2873563218390804,141.82030884185804
5122,972,4104,66,263,535,648,469,385,1708,180565,1.2181818181818185,606.7833221175414
5123,526,4104,33,225,604,791,571,566,2274,323186,1.0088339222614842,803.9881839927749
5124,1562,4104,21,202,601,809,580,607,2374,352060,0.9555189456342668,839.5528571805352
5125,480,4104,18,248,497,800,479,552,2062,264408,0.8677536231884058,730.8522422487325
5126,1389,4104,36,210,555,791,519,581,2200,301539,0.8932874354561101,779.0519879956664
5127,1508,4104,72,223,218,455,146,232,756,33872,0.6293103448275862,274.11676344215067
5128,1024,4104,48,215,547,825,499,610,2218,304390,0.8180327868852459,788.0996129931799
5129,969,4104,219,402,362,660,143,258,802,36894,0.5542635658914729,294.97966031575805
5130,959,16515,17,242,722,780,705,538,2486,379290,1.3104089219330854,886.8308745189242
5131,413,16515,335,234,636,607,301,373,1348,112273,0.8069705093833779,479.30157521126506
5132,1435,16515,283,236,747,778,464,542,2012,251488,0.8560885608856088,713.4844076782617
5133,746,16515,258,226,730,794,472,568,2080,268096,0.8309859154929577,738.5174337820333
5134,417,16515,503,359,557,405,54,46,200,2484,1.173913043478261,70.9365914038728
5135,521,16515,153,237,733,697,580,460,2080,266800,1.2608695652173914,740.2702209328698
5136,422,28422,103,904,320,1162,217,258,950,55986,0.8410852713178295,337.12460604352214
5137,1508,28422,125,905,309,1155,184,250,868,46000,0.736,310.4126286090822
5138,436,28422,135,898,298,1153,163,255,836,41565,0.6392156862745098,302.6450065671
5139,1435,20098,46,757,347,979,301,222,1046,66822,1.3558558558558558,374.0120318920235
5140,843,20098,90,747,281,926,191,179,740,34189,1.067039106145251,261.767072031606
5141,852,20098,59,742,374,1006,315,264,1158,83160,1.193181818181818,411.0
5142,71,20098,84,746,289,990,205,244,898,50020,0.8401639344262295,318.6863661972379
5143,30,20098,92,745,276,900,184,155,678,28520,1.1870967741935483,240.58470441821524
5144,1335,20098,39,744,188,877,149,133,564,19817,1.1203007518796992,199.7248106770914
5145,854,20098,286,759,287,761,1,2,6,2,0.5,2.23606797749979
5146,523,20098,34,733,367,1008,333,275,1216,91575,1.2109090909090907,431.87266641916574
5147,848,20098,105,757,293,861,188,104,584,19552,1.807692307692308,214.84878403193255
5148,153,28195,175,853,275,949,100,96,392,9600,1.0416666666666667,138.62178760930766
5149,379,28195,49,842,163,953,114,111,450,12654,1.027027027027027,159.11316727411344
5150,310,28195,41,830,276,961,235,131,732,30785,1.7938931297709924,269.04646438858845
5151,831,28195,53,803,275,985,222,182,808,40404,1.21978021978022,287.0679362102288
5152,1585,28195,58,848,273,972,215,124,678,26660,1.7338709677419355,248.1954874690513
5153,157,28195,47,840,151,947,104,107,422,11128,0.97196261682243,149.21461054467824
5154,1458,28195,63,839,260,962,197,123,640,24231,1.6016260162601623,232.24555969921147
5155,914,28195,171,842,281,959,110,117,454,12870,0.9401709401709402,160.58953888718904
5156,266,28195,51,817,276,1001,225,184,818,41400,1.2228260869565215,290.65615424415154
5157,1216,28195,50,827,167,976,117,149,532,17433,0.785234899328859,189.44656238633627
5158,917,28195,45,836,152,947,107,111,436,11877,0.9639639639639641,154.17522498767434
5159,678,22052,70,593,695,1130,625,537,2324,335625,1.1638733705772812,824.0109222577089
5160,1315,22052,48,594,636,1290,588,696,2568,409248,0.8448275862068966,911.1311650909544
5161,1470,22052,209,629,678,1066,469,437,1812,204953,1.0732265446224256,641.038220389393
5162,110,22052,114,663,720,1284,606,621,2454,376326,0.9758454106280192,867.684850622621
5163,119,22052,53,637,843,964,790,327,2234,258330,2.4159021406727827,855.0023391780867
5164,1222,22052,249,592,569,1081,320,489,1618,156480,0.65439672801636,584.3979808315563
5165,1408,22052,164,663,683,1257,519,594,2226,308286,0.8737373737373737,788.7946500832774
5166,1595,22052,291,578,721,1083,430,505,1870,217150,0.8514851485148515,663.2684222846735
5167,1371,22052,39,600,666,1292,627,692,2638,433884,0.9060693641618496,933.8056542985805
5168,1290,19964,63,1018,201,1088,138,70,416,9660,1.9714285714285715,154.7384890710776
5169,433,19964,51,1019,201,1088,150,69,438,10350,2.1739130434782608,165.10905486980417
5170,296,19964,54,1015,202,1091,148,76,448,11248,1.947368421052632,166.37307474468338
5171,1506,4094,191,605,522,978,331,373,1408,123463,0.8873994638069705,498.68827938903877
5172,1144,4094,139,570,582,945,443,375,1636,166125,1.1813333333333331,580.4084768505711
5173,1389,4094,156,601,513,989,357,388,1490,138516,0.9201030927835052,527.2504148884095
5174,1508,4094,232,610,357,688,125,78,406,9750,1.6025641025641026,147.33974345029924
5175,972,4094,186,587,531,970,345,383,1456,132135,0.9007832898172324,515.4745386534624
5176,909,11921,50,634,309,830,259,196,910,50764,1.3214285714285714,324.80301722736505
5177,1565,11921,33,626,330,833,297,207,1008,61479,1.4347826086956519,362.0193365001378
5178,1663,11921,31,629,303,831,272,202,948,54944,1.3465346534653466,338.803778019077
5179,748,11036,118,804,235,932,117,128,490,14976,0.9140625,173.4156855650607
5180,949,11036,46,784,417,1059,371,275,1292,102025,1.3490909090909091,461.8073191277938
5181,516,11036,85,782,417,1052,332,270,1204,89640,1.2296296296296296,427.92990080152146
5182,232,11036,101,797,416,1058,315,261,1152,82215,1.206896551724138,409.0794543850864
5183,354,11036,345,783,365,836,20,53,146,1060,0.37735849056603776,56.64803615307419
5184,1653,11036,55,780,426,1046,371,266,1274,98686,1.3947368421052628,456.50520259905034
5185,1061,11036,103,833,351,993,248,160,816,39680,1.55,295.13386793114745
5186,781,19022,48,1036,327,1298,279,262,1082,73098,1.0648854961832062,382.7335888055816
5187,997,19022,160,1106,340,1247,180,141,642,25380,1.2765957446808511,228.65038814749474
5188,1106,19022,63,1051,331,1283,268,232,1000,62176,1.1551724137931034,354.46861638232514
5189,1473,19022,59,1036,337,1293,278,257,1070,71446,1.0817120622568093,378.59344949430914
5190,66,19022,53,1034,330,1291,277,257,1068,71189,1.0778210116731517,377.85976234576765
5191,508,19022,75,1045,328,1265,253,220,946,55660,1.15,335.2745143908198
5192,1045,19022,228,1142,332,1249,104,107,422,11128,0.97196261682243,149.21461054467824
5193,109,19022,108,1038,343,1319,235,281,1032,66035,0.8362989323843416,366.31407289373965
5194,1391,7485,80,754,182,843,102,89,382,9078,1.146067415730337,135.36986370680884
5195,362,7485,73,752,167,833,94,81,350,7614,1.160493827160494,124.08464852672147
5196,1508,7485,24,784,108,867,84,83,334,6972,1.0120481927710845,118.0889495253472
5197,1620,7485,30,765,166,864,136,99,470,13464,1.3737373737373737,168.21712160181556
5198,1389,7485,28,753,168,868,140,115,510,16100,1.2173913043478262,181.1767093199344
5199,1442,7485,55,744,213,861,158,117,550,18486,1.3504273504273503,196.60366222428308
5203,15,23916,13,319,446,697,433,378,1622,163674,1.1455026455026456,574.7808277943864
5204,1010,23916,32,345,462,652,430,307,1474,132010,1.4006514657980456,528.3455308791775
5205,1122,23916,15,303,434,730,419,427,1692,178913,0.981264637002342,598.2390826417144
5206,1319,28597,96,371,179,464,83,93,352,7719,0.8924731182795699,124.65151423067431
5207,1367,28597,71,368,176,466,105,98,406,10290,1.0714285714285714,143.62799170078233
5208,932,28597,70,369,182,466,112,97,418,10864,1.154639175257732,148.16544806398016
5209,553,21067,105,483,948,1042,843,559,2804,471237,1.5080500894454385,1011.4988877897988
5210,1025,21067,242,461,515,900,273,439,1424,119847,0.621867881548975,516.9622810225133
5211,1158,21067,107,470,974,1064,867,594,2922,514998,1.4595959595959596,1050.9638433362015
5212,1689,21067,144,481,725,907,581,426,2014,247506,1.363849765258216,720.4422253033202
5213,57,21067,119,474,899,1098,780,624,2808,486720,1.25,998.8873810395244
5214,379,23267,54,842,276,1045,222,203,850,45066,1.0935960591133005,300.8205445111753
5215,710,23267,51,831,324,1048,273,217,980,59241,1.2580645161290325,348.7377237982722
5216,375,23267,98,829,290,1055,192,226,836,43392,0.8495575221238938,296.54679226051326
5217,1159,23267,41,828,336,1068,295,240,1070,70800,1.2291666666666667,380.2959373961284
5218,1357,23267,46,833,313,1063,267,230,994,61410,1.1608695652173913,352.40459701882435
5219,1684,23267,85,839,314,1034,229,195,848,44655,1.1743589743589744,300.77566390916667
5220,203,15960,44,472,165,536,121,64,370,7744,1.890625,136.88316185711082
5221,651,15960,31,477,181,549,150,72,444,10800,2.083333333333333,166.38509548634457
5222,755,15960,23,469,176,551,153,82,470,12546,1.8658536585365852,173.5885940953495
5223,88,15960,25,475,102,523,77,48,250,3696,1.6041666666666667,90.7358804442873
5224,909,15960,36,474,175,539,139,65,408,9035,2.1384615384615384,153.44705927452634
5225,857,15960,30,472,73,522,43,50,186,2150,0.86,65.94694837519019
5226,1452,15960,28,473,184,549,156,76,464,11856,2.0526315789473686,173.5280957078709
5227,783,9894,48,331,325,480,277,149,852,41273,1.859060402684564,314.5313974788527
5228,114,9894,84,343,248,491,164,148,624,24272,1.108108108108108,220.90722034374522
5229,66,9894,37,335,324,487,287,152,878,43624,1.8881578947368418,324.7660696562989
5230,453,9894,47,362,258,493,211,131,684,27641,1.6106870229007633,248.35861168882386
5231,514,9894,29,337,344,462,315,125,880,39375,2.52,338.89526405661087
5232,886,9894,36,337,332,473,296,136,864,40256,2.176470588235294,325.7483691440373
5233,1081,27601,55,574,937,1438,882,864,3492,762048,1.0208333333333333,1234.6740460542612
5234,371,27601,41,542,503,1408,462,866,2656,400092,0.5334872979214781,981.5294188153506
5235,1257,27601,537,621,923,1358,386,737,2246,284482,0.5237449118046132,831.9645425136819
5236,768,27601,52,562,503,1390,451,828,2558,373428,0.5446859903381642,942.860010818149
5237,1585,27601,58,585,469,1410,411,825,2472,339075,0.4981818181818182,921.7081967737946
5238,831,27601,64,627,917,1271,853,644,2994,549332,1.3245341614906831,1068.8054079204503
5239,1305,27601,108,738,465,1344,357,606,1926,216342,0.5891089108910891,703.3384675957942
5240,538,27601,47,612,909,1375,862,763,3250,657706,1.1297509829619918,1151.1789608918327
5241,53,27601,70,682,491,1291,421,609,2060,256389,0.6912972085385879,740.3526186892298
5242,1751,27601,86,579,898,1383,812,804,3232,652848,1.0099502487562189,1142.698560426152
5243,1034,27601,108,680,488,1288,380,608,1976,231040,0.625,716.9825660363019
5244,1587,15096,55,843,90,874,35,31,132,1085,1.1290322580645162,46.75467891024384
5245,447,15096,46,842,85,877,39,35,148,1365,1.1142857142857143,52.40229002629561
5246,1581,15096,55,845,79,872,24,27,102,648,0.8888888888888888,36.124783736376884
5247,1684,15096,54,842,83,875,29,33,124,957,0.8787878787878788,43.93176527297759
5248,56,15096,46,842,83,876,37,34,142,1258,1.088235294117647,50.24937810560445
5249,1681,15096,50,846,91,873,41,27,136,1107,1.5185185185185186,49.09175083453431
5250,552,15096,53,844,86,875,33,31,128,1023,1.064516129032258,45.27692569068709
5251,391,30699,48,525,505,797,457,272,1458,124304,1.6801470588235294,531.8204584255856
5252,226,30699,53,536,500,814,447,278,1450,124266,1.6079136690647482,526.396238588385
5253,118,30699,55,524,500,800,445,276,1442,122820,1.6123188405797102,523.6420533150484
5254,3,12831,139,1064,342,1191,203,127,660,25781,1.5984251968503935,239.45354455509738
5255,1320,12831,139,1043,328,1161,189,118,614,22302,1.6016949152542372,222.81157959136684
5256,1638,12831,141,1064,346,1184,205,120,650,24600,1.7083333333333333,237.53947040439405
5257,1102,12831,139,1083,349,1197,210,114,648,23940,1.8421052631578947,238.94769302087852
5258,656,35081,53,982,229,1160,176,178,708,31328,0.9887640449438202,250.3197954617253
5259,1457,35081,68,992,217,1162,149,170,638,25330,0.8764705882352941,226.05530296810116
5260,164,35081,58,987,233,1167,175,180,710,31500,0.9722222222222222,251.04780421266383
5261,1540,5466,49,471,190,632,141,161,604,22701,0.8757763975155279,214.0140182324513
5262,681,5466,32,480,33,481,1,1,4,1,1.0,1.4142135623730951
5263,11,5466,52,472,181,630,129,158,574,20382,0.8164556962025317,203.9730374338726
5264,577,5444,262,50,813,835,551,785,2672,432535,0.7019108280254777,959.0755966033126
5265,11,5444,336,132,725,807,389,675,2128,262575,0.5762962962962963,779.0673911799928
5266,952,5444,428,210,515,372,87,162,498,14094,0.5370370370370371,183.88311504866346
5267,632,5444,24,48,985,825,961,777,3476,746697,1.2368082368082367,1235.8195661179668
5268,1540,5444,336,90,754,810,418,720,2276,300960,0.5805555555555556,832.5406896963054
5269,681,5444,407,175,571,462,164,287,902,47068,0.5714285714285714,330.55256768024054
5270,952,33518,66,799,118,847,52,48,200,2496,1.0833333333333333,70.76722405181653
5271,1191,33518,74,811,132,844,58,33,182,1914,1.7575757575757576,66.73080248281148
5272,191,33518,68,817,112,845,44,28,144,1232,1.5714285714285714,52.15361924162119
5273,957,33518,51,791,133,849,82,58,280,4756,1.4137931034482758,100.43903623591775
5274,128,33518,38,788,143,858,105,70,350,7350,1.5,126.19429464123962
5275,1055,33518,55,798,122,851,67,53,240,3551,1.2641509433962264,85.42833253669417
5276,805,21578,266,662,562,998,296,336,1264,99456,0.8809523809523809,447.78566301300896
5277,1562,21578,246,679,546,991,300,312,1224,93600,0.9615384615384616,432.8325311249144
5278,966,21578,148,645,894,1034,746,389,2270,290194,1.917737789203085,841.3304939201954
5279,809,21578,32,572,894,1113,862,541,2806,466342,1.5933456561922366,1017.7057531526488
5280,592,21578,40,556,955,1112,915,556,2942,508740,1.6456834532374098,1070.68249261861
5281,93,21578,83,583,956,1115,873,532,2810,464436,1.6409774436090223,1022.3272470202484
5282,360,16468,183,880,535,1148,352,268,1240,94336,1.3134328358208955,442.41157308551504
5283,1508,16468,178,850,306,1047,128,197,650,25216,0.649746192893401,234.93190502781866
5284,36,16468,216,886,434,1133,218,247,930,53846,0.8825910931174089,329.4434701128556
5285,1730,16468,122,876,553,1139,431,263,1388,113353,1.6387832699619767,504.9059318328514
5286,1557,16468,185,891,520,1163,335,272,1214,91120,1.2316176470588236,431.5194086017453
5287,644,16468,184,871,506,1168,322,297,1238,95634,1.084175084175084,438.0559325017754
5288,909,16468,170,837,382,1027,212,190,804,40280,1.1157894736842104,284.682279041039
5289,902,16468,137,892,532,1187,395,295,1380,116525,1.3389830508474576,493.0010141977398
5290,480,4547,262,442,660,556,398,114,1024,45372,3.4912280701754392,414.004830889689
5291,1024,4547,490,456,634,549,144,93,474,13392,1.5483870967741935,171.42053552593984
5292,1508,4547,480,410,582,531,102,121,446,12342,0.8429752066115702,158.25612152457168
5293,365,4547,335,400,626,525,291,125,832,36375,2.3280000000000003,316.7112249352713
5294,692,4547,185,395,642,549,457,154,1222,70378,2.967532467532468,482.24993519958093
5295,526,4547,309,406,617,565,308,159,934,48972,1.9371069182389935,346.6193878016635
5296,1144,4547,120,323,756,727,636,404,2080,256944,1.5742574257425743,753.4666548693446
5297,1389,4547,268,446,333,509,65,63,256,4095,1.031746031746032,90.52071586106685
5298,1684,35851,31,540,183,621,152,81,466,12312,1.8765432098765433,172.23530416264836
5299,378,35851,29,531,193,640,164,109,546,17876,1.5045871559633028,196.91876497682998
5300,828,35851,25,540,193,641,168,101,538,16968,1.6633663366336633,196.02295783912658
5301,955,33942,53,497,274,653,221,156,754,34476,1.4166666666666667,270.51247660690257
5302,952,33942,127,521,256,625,129,104,466,13416,1.2403846153846154,165.7015389186232
5303,1380,33942,60,499,273,649,213,150,726,31950,1.42,260.51679408437377
5304,182,33942,74,504,272,654,198,150,696,29700,1.32,248.4028985338134
5305,1645,33942,114,513,217,670,103,157,520,16171,0.6560509554140127,187.77113729218343
5306,410,33942,86,504,269,636,183,132,630,24156,1.3863636363636365,225.63909235768523
5307,415,33942,146,576,243,658,97,82,358,7954,1.1829268292682926,127.01574705523721
5308,1418,26391,88,583,398,854,310,271,1162,84010,1.1439114391143912,411.7535670762307
5309,181,26391,108,601,446,861,338,260,1196,87880,1.3,426.4317061382749
5310,115,26391,70,585,429,878,359,293,1304,105187,1.2252559726962458,463.38968482261237
5311,567,26391,144,624,391,827,247,203,900,50141,1.2167487684729064,319.71549852955206
5312,1323,26391,88,590,404,871,316,281,1194,88796,1.124555160142349,422.8675915697489
5313,1643,26391,112,583,398,850,286,267,1106,76362,1.0711610486891383,391.26078259902306
5314,387,26391,128,612,385,845,257,233,980,59881,1.1030042918454936,346.8976794387648
5315,1698,26391,144,601,394,811,250,210,920,52500,1.1904761904761905,326.49655434629017
5316,1268,26391,135,537,341,826,206,289,990,59534,0.71280276816609,354.9042124292131
5317,616,27959,272,444,609,780,337,336,1346,113232,1.0029761904761905,475.88338907761846
5318,66,27959,223,421,642,826,419,405,1648,169695,1.034567901234568,582.7400792806343
5319,269,27959,226,451,609,798,383,347,1460,132901,1.1037463976945243,516.8152474530913
5320,761,622,475,850,478,852,3,2,10,6,1.5,3.605551275463989
5321,425,622,171,808,501,1159,330,351,1362,115830,0.9401709401709402,481.76861666156714
5322,1195,622,53,793,579,1179,526,386,1824,203036,1.362694300518135,652.4354374189066
5323,1383,622,63,784,514,1181,451,397,1696,179047,1.1360201511335013,600.841077157679
5324,1562,622,135,846,524,1152,389,306,1390,119034,1.2712418300653594,494.9313083651104
5325,600,20735,27,534,387,774,360,240,1200,86400,1.5,432.6661530556787
5326,1302,20735,199,578,325,734,126,156,564,19656,0.8076923076923077,200.52929960482084
5327,1158,20735,83,535,386,781,303,246,1098,74538,1.2317073170731707,390.2883549377306
5328,1156,20735,130,591,335,704,205,113,636,23165,1.8141592920353984,234.081182498722
5329,919,20735,139,540,390,794,251,254,1010,63754,0.9881889763779528,357.0952253951318
5330,981,20735,161,535,381,791,220,256,952,56320,0.859375,337.5440711966365
5331,1623,20735,131,549,385,770,254,221,950,56134,1.1493212669683257,336.68531301498734
5332,1521,20735,60,547,387,789,327,242,1138,79134,1.3512396694214877,406.80830866637916
5333,157,20735,35,538,383,772,348,234,1164,81432,1.4871794871794872,419.35665012015727
5334,612,28736,72,757,260,881,188,124,624,23312,1.5161290322580645,225.21101216414795
5335,278,28736,59,756,256,872,197,116,626,22852,1.6982758620689655,228.61539755668252
5336,61,28736,108,752,211,882,103,130,466,13390,0.7923076923076923,165.85837331892532
